-118 -127 -118 -118 -118 -118 -118 -118 -118 -118 -118 -118 -118 -118 -118 -118 -118 -118 -118 -118 -118 -118 -118 -118 -118 -118 -118 -118 -118 -118 -118 -118 -118 -118 -118 -118 -118 -118 -118 -118 -118 -118 -118 -118 -118 -118 -118 -118 -118 -118 -118 -118 -118 -127 -127 -118 -118 -118 -118 -118 -118 -118 -118 -118 
-118 -118 -118 -118 -118 -118 -118 -118 -118 -118 -118 -118 -118 -127 -118 -118 -118 -118 -118 -127 -118 -118 -118 -118 -118 -118 -118 -118 -118 -118 -118 -118 -118 -118 -118 -118 -118 -118 -118 -118 -118 -127 -118 -118 -118 -118 -118 -118 -118 -118 -118 -118 -118 -118 -118 -118 -118 -118 -118 -118 -118 -118 -118 -118 
-118 -127 -118 -118 -118 -118 -118 -118 -118 -118 -118 -118 -127 -118 -118 -118 -118 -127 -118 -118 -118 -118 -127 -118 -118 -118 -118 -118 -118 -118 -118 -118 -118 -118 -118 -118 -118 -118 -118 -118 -118 -118 -118 -118 -118 -118 -118 -118 -127 -118 -127 -118 -118 -118 -118 -118 -118 -118 -118 -127 -118 -118 -127 -118 
-118 -118 -118 -118 -118 -118 -118 -118 -118 -118 -118 -118 -118 -118 -118 -118 -118 -127 -118 -118 -127 -118 -118 -118 -118 -118 -118 -118 -118 -127 -118 -118 -127 -118 -118 -118 -118 -118 -118 -118 -118 -118 -118 -118 -118 -118 -118 -118 -118 -118 -118 -118 -118 -118 -127 -118 -118 -118 -118 -118 -118 -118 -118 -118 
-118 -127 -118 -118 -118 -118 -118 -127 -118 -118 -118 -118 -118 -118 -118 -118 -118 -118 -118 -118 -118 -118 -118 -118 -118 -118 -118 -127 -118 -118 -118 -118 -118 -118 -118 -118 -118 -118 -118 -118 -118 -118 -118 -118 -118 -127 -118 -118 -118 -118 -118 -118 -118 -118 -118 -118 -118 -118 -118 -118 -127 -118 -118 -118 
-118 -118 -118 -118 -118 -118 -127 -118 -118 -118 -118 -118 -118 -118 -118 -118 -118 -118 -118 -118 -118 -118 -118 -118 -118 -118 -127 -118 -118 -127 -118 -118 -118 -118 -118 -127 -118 -118 -127 -118 -118 -118 -118 -118 -118 -118 -117 -118 -118 -118 -118 -118 -118 -118 -118 -118 -118 -118 -118 -118 -118 -118 -118 -118 
-118 -118 -118 -118 -118 -118 -118 -118 -118 -127 -118 -118 -118 -118 -118 -118 -118 -118 -118 -118 -118 -118 -118 -118 -118 -118 -118 -118 -118 -118 -118 -118 -118 -118 -118 -118 -118 -118 -118 -118 -118 -118 -118 -118 -117 -117 -115 -117 -117 -118 -118 -118 -118 -118 -125 -118 -118 -118 -118 -118 -118 -118 -118 -118 
-118 -118 -118 -118 -118 -127 -118 -118 -118 -118 -118 -118 -118 -118 -118 -118 -118 -118 -118 -118 -118 -118 -118 -118 -118 -118 -118 -118 -118 -118 -118 -118 -118 -118 -118 -118 -118 -118 -118 -118 -118 -118 -118 -118 -117 -115 -112 -115 -117 -118 -118 -118 -118 -118 -118 -118 -118 -118 -118 -118 -118 -118 -118 -118 
-118 -118 -118 -118 -118 -118 -118 -118 -118 -118 -118 -118 -118 -118 -118 -118 -118 -118 -118 -118 -118 -118 -127 -118 -118 -118 -118 -118 -118 -118 -118 -118 -118 -118 -118 -118 -118 -118 -118 -118 -118 -118 -118 -117 -115 -112 -108 -112 -115 -117 -118 -118 -118 -118 -118 -118 -118 -118 -118 -118 -118 -118 -118 -118 
-127 -118 -118 -127 -118 -118 -118 -118 -118 -118 -118 -118 -118 -118 -118 -118 -118 -118 -118 -118 -118 -118 -118 -127 -118 -118 -118 -118 -118 -118 -118 -118 -118 -118 -118 -118 -118 -118 -118 -118 -118 -118 -118 -118 -117 -115 -112 -115 -117 -118 -118 -118 -118 -118 -118 -118 -118 -118 -118 -118 -118 -118 -118 -118 
-118 -118 -118 -118 -118 -118 -118 -118 -118 -118 -127 -118 -118 -118 -118 -118 -118 -127 -118 -118 -118 -118 -118 -118 -118 -118 -118 -118 -118 -118 -118 -118 -118 -118 -118 -118 -118 -118 -118 -118 -118 -118 -118 -118 -117 -117 -115 -117 -117 -118 -118 -118 -118 -118 -118 -118 -118 -118 -118 -118 -118 -118 -127 -118 
-118 -118 -118 -118 -118 -118 -118 -118 -118 -118 -118 -118 -118 -118 -118 -118 -118 -118 -118 -118 -118 -127 -118 -127 -118 -118 -118 -118 -118 -118 -118 -118 -118 -118 -118 -118 -118 -118 -118 -118 -118 -118 -118 -118 -118 -118 -117 -118 -118 -118 -118 -118 -118 -118 -118 -118 -118 -118 -118 -118 -118 -118 -118 -118 
-118 -118 -118 -118 -118 -118 -118 -98 -118 -118 -118 -118 -118 -118 -118 -118 -118 -118 -118 -118 -118 -118 -118 -118 -118 -127 -118 -118 -118 -118 -118 -118 -118 -118 -127 -127 -118 -118 -118 -118 -118 -118 -127 -118 -118 -118 -118 -118 -118 -118 -118 -118 -118 -118 -118 -118 -118 -118 -127 -118 -118 -118 -118 -118 
-118 -118 -118 -118 -118 -98 -98 -76 -98 -98 -118 -118 -118 -118 -118 -118 -118 -118 -118 -118 -118 -118 -118 -127 -118 -118 -118 -118 -118 -127 -118 -118 -118 -118 -118 -118 -118 -118 -118 -118 -127 -118 -118 -118 -127 -118 -118 -118 -118 -118 -118 -118 -118 -118 -118 -118 -118 -118 -118 -118 -118 -118 -118 -118 
-118 -118 -118 -118 -98 -76 -76 -33 -76 -76 -76 -118 -118 -127 -118 -118 -127 -118 -118 -118 -118 -118 -118 -118 -118 -118 -118 -118 -127 -118 -118 -118 -118 -118 -118 -118 -118 -118 -118 -127 -118 -118 -118 -118 -118 -118 -118 -118 -118 -118 -118 -118 -118 -118 -118 -118 -118 -127 -118 -118 -118 -118 -118 -118 
-118 -118 -118 -118 -98 -55 -33 0 -13 -33 -51 -98 -98 -118 -118 -118 -118 -118 -118 -118 -118 -118 -118 -118 -118 -118 -118 -118 -118 -118 -118 -118 -118 -118 -118 -118 -118 -118 -118 -118 -118 -118 -118 -118 -118 -118 -118 -118 -118 -118 -118 -118 -118 -118 -118 -118 -118 -127 -118 -118 -118 -118 -118 -118 
-118 -118 -118 -98 -55 -13 0 63 31 6 6 -51 -76 -98 -127 -118 -118 -127 -118 -118 -118 -118 -118 -118 -118 -118 -118 -118 -118 -118 -118 -118 -118 -118 -118 -118 -118 -118 -118 -118 -118 -118 -118 -118 -118 -118 -118 -118 -126 -118 -118 -118 -118 -118 -118 -127 -118 -118 -118 -118 -118 -118 -118 -118 
-118 -118 -118 -118 -76 -23 0 69 63 45 40 -25 -51 -98 -118 -127 -118 -118 -118 -118 -118 -118 -118 -118 -118 -118 -118 -118 -118 -118 -118 -118 -118 -118 -118 -118 -118 -118 -118 -118 -118 -127 -118 -118 -118 -118 -127 -118 -118 -118 -118 -118 -118 -118 -118 -118 -118 -118 -118 -118 -118 -118 -118 -118 
-118 -118 -118 -101 -50 0 23 128 116 116 108 6 -1 -51 -100 -118 -118 -118 -118 -118 -118 -118 -118 -118 -118 -118 -118 -118 -118 -118 -118 -118 -118 -118 -118 -118 -118 -118 -118 -118 -127 -118 -118 -118 -127 -118 -118 -118 -118 -118 -118 -118 -118 -118 -118 -118 -118 -118 -118 -118 -118 -118 -118 -118 
-118 -118 -118 -118 -90 -34 -6 68 61 76 71 0 -25 -76 -118 -127 -118 -118 -118 -118 -118 -118 -118 -118 -118 -118 -118 -118 -118 -118 -118 -118 -118 -118 -118 -118 -118 -118 -118 -118 -118 -118 -118 -118 -118 -118 -118 -118 -118 -118 -118 -118 -118 -118 -118 -127 -118 -118 -118 -118 -118 -118 -118 -118 
-118 -118 -118 -116 -85 -55 -24 48 45 56 74 0 -1 -51 -101 -118 -118 -118 -127 -118 -118 -118 -118 -118 -118 -118 -118 -118 -127 -118 -118 -118 -118 -118 -118 -118 -118 -118 -118 -118 -118 -127 -118 -118 -118 -118 -118 -118 -118 -118 -118 -118 -118 -118 -118 -118 -118 -118 -118 -118 -118 -118 -127 -118 
-118 -127 -118 -118 -112 -80 -77 -24 -6 0 0 -25 -51 -99 -118 -118 -118 -118 -118 -118 -118 -118 -118 -118 -118 -118 -118 -118 -118 -118 -118 -118 -118 -118 -118 -118 -118 -118 -118 -118 -118 -118 -118 -118 -127 -118 -118 -118 -118 -118 -118 -118 -118 -118 -118 -118 -118 -118 -118 -118 -118 -118 -127 -118 
-118 -118 -118 -118 -116 -104 -104 -53 -59 -59 -23 -76 -76 -101 -118 -118 -118 -118 -118 -118 -118 -118 -118 -118 -118 -118 -118 -118 -127 -118 -118 -126 -118 -118 -118 -118 -118 -118 -118 -118 -118 -118 -118 -118 -118 -118 -118 -118 -118 -118 -118 -118 -118 -118 -118 -118 -118 -118 -118 -118 -118 -118 -118 -118 
-118 -127 -117 -118 -116 -116 -116 -104 -93 -93 -76 -101 -101 -118 -118 -118 -127 -118 -118 -118 -118 -118 -127 -118 -118 -118 -118 -118 -126 -118 -118 -118 -118 -118 -118 -118 -118 -118 -118 -118 -118 -118 -118 -118 -118 -118 -118 -118 -118 -118 -118 -118 -118 -118 -118 -127 -118 -127 -127 -118 -118 -118 -118 -118 
-117 -117 -100 -107 -100 -116 -116 -116 -118 -118 -101 -118 -118 -118 -118 -118 -118 -118 -118 -118 -118 -118 -118 -127 -118 -118 -118 -118 -118 -118 -118 -118 -118 -118 -118 -118 -118 -118 -118 -118 -118 -118 -118 -118 -118 -118 -118 -127 -118 -118 -118 -118 -118 -118 -118 -118 -118 -118 -127 -118 -118 -127 -118 -118 
-107 -100 -84 -94 -92 -100 -108 -116 -118 -118 -118 -118 -118 -118 -118 -118 -118 -118 -118 -118 -118 -118 -118 -118 -118 -118 -118 -118 -118 -118 -118 -118 -118 -118 -118 -118 -118 -118 -118 -118 -118 -118 -118 -118 -118 -118 -118 -118 -118 -118 -118 -118 -118 -118 -118 -118 -127 -118 -118 -118 -118 -127 -118 -127 
-102 -92 -72 -75 -77 -96 -108 -116 -118 -118 -118 -118 -118 -118 -118 -118 -118 -118 -118 -118 -127 -118 -118 -118 -127 -126 -118 -118 -118 -118 -118 -118 -118 -118 -118 -118 -118 -118 -118 -118 -118 -118 -118 -118 -118 -118 -118 -118 -118 -127 -118 -118 -118 -118 -118 -127 -118 -118 -118 -118 -118 -118 -118 -118 
-88 -72 -57 -63 -62 -77 -96 -108 -116 -118 -118 -116 -118 -118 -118 -118 -118 -118 -118 -118 -118 -118 -118 -118 -118 -118 -118 -118 -118 -118 -118 -118 -118 -118 -118 -118 -118 -118 -118 -118 -118 -118 -118 -118 -118 -127 -118 -118 -118 -118 -118 -118 -127 -127 -118 -118 -118 -118 -118 -118 -118 -127 -127 -118 
-99 -83 -67 -70 -75 -93 -108 -116 -118 -116 -116 -101 -116 -116 -118 -118 -118 -118 -118 -118 -118 -118 -118 -118 -118 -118 -118 -118 -118 -118 -118 -118 -118 -118 -118 -118 -118 -118 -118 -118 -118 -118 -118 -118 -118 -118 -118 -118 -118 -118 -118 -118 -118 -118 -118 -118 -118 -118 -118 -118 -118 -118 -127 -118 
-97 -91 -70 -81 -76 -95 -104 -116 -108 -101 -101 -95 -101 -101 -116 -118 -118 -118 -118 -118 -118 -118 -118 -118 -118 -118 -118 -118 -118 -118 -118 -118 -118 -118 -118 -118 -118 -118 -118 -118 -118 -118 -118 -118 -118 -118 -118 -118 -118 -118 -118 -118 -118 -118 -118 -118 -118 -118 -118 -118 -127 -118 -118 -118 
-109 -103 -91 -99 -95 -115 -112 -117 -101 -98 -91 -84 -95 -101 -116 -118 -118 -118 -118 -118 -118 -118 -118 -118 -118 -118 -118 -118 -118 -118 -118 -118 -118 -118 -118 -118 -118 -118 -118 -118 -118 -118 -127 -118 -118 -118 -118 -118 -118 -118 -118 -118 -118 -118 -118 -118 -118 -118 -118 -118 -118 -118 -118 -118 
-117 -117 -103 -117 -110 -117 -116 -101 -93 -86 -74 -70 -84 -95 -101 -116 -118 -118 -118 -118 -118 -118 -127 -118 -118 -118 -118 -118 -118 -118 -118 -118 -118 -118 -118 -118 -118 -118 -118 -118 -127 -118 -118 -118 -118 -118 -118 -118 -118 -118 -118 -118 -118 -118 -118 -118 -118 -118 -118 -118 -118 -118 -118 -118 
-117 -117 -117 -117 -117 -117 -116 -109 -95 -93 -86 -78 -95 -101 -116 -118 -118 -118 -118 -118 -118 -118 -118 -118 -118 -118 -118 -120 -118 -118 -118 -118 -118 -118 -118 -118 -118 -118 -118 -118 -118 -118 -118 -127 -118 -118 -118 -118 -127 -118 -118 -118 -118 -118 -118 -118 -118 -118 -118 -127 -118 -118 -118 -118 
-118 -118 -117 -125 -117 -116 -109 -104 -93 -87 -93 -86 -98 -101 -116 -118 -118 -118 -118 -118 -118 -118 -118 -118 -118 -118 -127 -118 -117 -118 -118 -118 -118 -118 -118 -118 -118 -118 -118 -118 -118 -118 -118 -118 -118 -118 -118 -118 -118 -118 -118 -118 -118 -118 -118 -118 -117 -118 -118 -118 -118 -118 -118 -118 
-118 -118 -118 -118 -118 -117 -116 -109 -104 -99 -101 -98 -116 -116 -118 -118 -118 -118 -118 -118 -118 -118 -118 -118 -118 -118 -117 -117 -107 -117 -117 -118 -118 -118 -118 -118 -118 -118 -127 -118 -118 -118 -118 -118 -118 -127 -118 -127 -118 -118 -127 -118 -127 -118 -117 -117 -103 -117 -117 -118 -118 -118 -118 -118 
-118 -118 -118 -118 -118 -117 -116 -116 -109 -116 -116 -108 -118 -118 -118 -118 -118 -118 -118 -118 -118 -118 -118 -118 -126 -117 -109 -108 -99 -105 -105 -114 -118 -118 -118 -118 -118 -118 -118 -118 -118 -127 -118 -118 -118 -118 -118 -118 -118 -118 -118 -118 -118 -117 -103 -103 -96 -103 -103 -117 -118 -118 -118 -118 
-118 -118 -118 -118 -118 -118 -117 -117 -116 -117 -117 -118 -118 -118 -118 -118 -118 -118 -118 -118 -118 -118 -118 -118 -118 -117 -109 -99 -95 -99 -105 -117 -118 -118 -118 -118 -118 -118 -118 -118 -118 -118 -118 -118 -125 -118 -118 -118 -118 -118 -118 -118 -118 -117 -103 -96 -81 -96 -103 -117 -118 -118 -118 -127 
-118 -118 -118 -118 -118 -118 -118 -118 -117 -118 -118 -118 -118 -118 -118 -125 -118 -118 -118 -118 -118 -118 -118 -118 -117 -109 -99 -95 -89 -94 -99 -105 -117 -118 -118 -118 -118 -118 -118 -118 -118 -118 -118 -118 -118 -118 -123 -118 -125 -118 -118 -118 -117 -103 -95 -81 -75 -81 -95 -103 -117 -118 -118 -118 
-118 -118 -118 -118 -118 -118 -118 -118 -118 -118 -118 -118 -118 -118 -118 -118 -118 -118 -118 -118 -118 -118 -118 -118 -118 -117 -109 -99 -95 -99 -108 -117 -118 -118 -118 -118 -118 -118 -118 -118 -118 -118 -118 -118 -118 -118 -122 -118 -118 -118 -118 -118 -118 -111 -100 -91 -78 -91 -100 -111 -118 -118 -118 -118 
-118 -118 -118 -118 -118 -118 -118 -118 -118 -118 -118 -118 -118 -118 -118 -118 -118 -118 -118 -118 -118 -118 -118 -118 -118 -117 -109 -109 -99 -109 -109 -117 -118 -118 -118 -118 -118 -118 -118 -118 -118 -118 -118 -118 -118 -118 -118 -118 -118 -118 -118 -118 -118 -105 -97 -94 -79 -94 -97 -105 -118 -118 -118 -118 
-118 -127 -118 -118 -118 -118 -118 -118 -118 -118 -118 -118 -118 -118 -118 -118 -118 -118 -118 -118 -118 -118 -118 -118 -118 -118 -117 -117 -109 -117 -117 -118 -118 -118 -118 -117 -118 -118 -118 -118 -118 -118 -118 -118 -118 -118 -118 -125 -118 -118 -118 -118 -118 -117 -103 -101 -79 -101 -103 -117 -118 -127 -118 -118 
-118 -118 -118 -118 -118 -118 -118 -118 -118 -118 -118 -118 -118 -118 -118 -118 -118 -118 -118 -118 -118 -118 -118 -118 -118 -118 -127 -118 -117 -118 -118 -118 -118 -118 -118 -118 -118 -118 -118 -118 -118 -118 -118 -118 -118 -118 -118 -118 -118 -118 -118 -118 -118 -117 -103 -101 -79 -101 -103 -117 -127 -118 -118 -118 
-118 -118 -118 -118 -118 -118 -118 -118 -118 -118 -118 -118 -118 -118 -118 -118 -118 -118 -118 -118 -118 -118 -118 -118 -127 -118 -118 -118 -118 -118 -118 -118 -118 -118 -118 -118 -118 -118 -118 -118 -118 -118 -118 -118 -118 -118 -118 -118 -118 -118 -118 -118 -118 -105 -97 -94 -79 -94 -97 -105 -118 -127 -118 -118 
-118 -118 -118 -118 -118 -118 -118 -118 -127 -118 -118 -118 -118 -118 -118 -118 -118 -118 -118 -118 -118 -118 -118 -118 -118 -118 -118 -118 -118 -118 -118 -118 -118 -118 -118 -118 -118 -118 -118 -118 -118 -118 -118 -118 -118 -127 -118 -118 -118 -118 -118 -118 -118 -111 -100 -91 -78 -91 -100 -111 -118 -118 -118 -118 
-118 -118 -118 -118 -118 -118 -118 -118 -118 -118 -118 -118 -118 -118 -118 -118 -118 -118 -118 -118 -118 -118 -127 -118 -118 -118 -118 -118 -118 -118 -118 -118 -118 -118 -118 -118 -118 -118 -118 -118 -118 -118 -118 -118 -118 -118 -118 -118 -118 -118 -118 -118 -117 -103 -95 -81 -75 -81 -95 -103 -117 -118 -118 -118 
-118 -118 -118 -118 -118 -118 -118 -118 -118 -118 -118 -118 -118 -118 -118 -118 -118 -127 -118 -118 -118 -118 -118 -118 -118 -118 -118 -118 -118 -118 -118 -118 -118 -118 -127 -118 -118 -118 -118 -118 -118 -118 -118 -118 -118 -118 -118 -118 -118 -118 -118 -118 -121 -117 -103 -96 -81 -96 -103 -117 -118 -118 -118 -118 
-118 -118 -118 -118 -127 -118 -118 -118 -118 -127 -118 -118 -127 -118 -118 -118 -118 -118 -118 -118 -118 -118 -118 -118 -118 -118 -118 -118 -118 -118 -118 -118 -118 -118 -118 -118 -118 -118 -118 -118 -118 -118 -118 -118 -118 -118 -118 -118 -118 -118 -118 -118 -118 -117 -103 -103 -96 -103 -103 -117 -118 -118 -118 -118 
-118 -118 -118 -118 -118 -118 -118 -118 -118 -118 -118 -118 -118 -127 -118 -127 -118 -118 -118 -118 -118 -118 -118 -118 -118 -118 -118 -118 -118 -118 -118 -118 -118 -118 -118 -118 -118 -118 -118 -118 -118 -118 -118 -118 -118 -118 -118 -118 -118 -118 -118 -118 -118 -118 -117 -117 -103 -117 -117 -118 -118 -118 -118 -118 
-118 -118 -118 -118 -118 -118 -118 -118 -118 -118 -118 -118 -118 -118 -118 -118 -118 -118 -118 -118 -118 -118 -118 -118 -118 -127 -118 -118 -118 -118 -118 -118 -118 -118 -118 -127 -118 -118 -118 -118 -118 -118 -118 -118 -118 -118 -118 -118 -118 -118 -118 -118 -118 -118 -118 -118 -117 -118 -118 -127 -118 -118 -118 -118 
-118 -127 -118 -118 -118 -118 -118 -118 -118 -118 -118 -118 -118 -118 -118 -118 -118 -118 -118 -118 -127 -127 -118 -118 -118 -118 -118 -118 -118 -118 -118 -118 -118 -118 -118 -118 -118 -118 -118 -118 -127 -118 -118 -118 -118 -118 -127 -118 -118 -118 -118 -118 -118 -118 -118 -118 -118 -118 -118 -118 -118 -118 -118 -118 
-118 -118 -118 -118 -118 -118 -118 -118 -118 -118 -118 -118 -118 -118 -118 -118 -118 -118 -118 -118 -118 -127 -118 -118 -118 -127 -118 -118 -118 -118 -118 -118 -127 -118 -118 -118 -118 -118 -118 -127 -118 -118 -118 -118 -118 -118 -118 -118 -118 -118 -118 -118 -118 -118 -118 -118 -118 -118 -118 -118 -118 -127 -118 -118 
-118 -118 -118 -118 -118 -118 -118 -118 -118 -118 -118 -118 -118 -118 -118 -118 -118 -118 -118 -118 -118 -118 -127 -118 -118 -118 -118 -118 -118 -118 -127 -118 -118 -118 -118 -118 -118 -118 -118 -118 -118 -118 -118 -118 -118 -118 -118 -118 -118 -118 -118 -118 -127 -118 -118 -118 -118 -118 -127 -118 -118 -118 -118 -118 
-118 -118 -118 -118 -118 -118 -118 -127 -127 -118 -118 -118 -118 -118 -118 -118 -118 -118 -118 -118 -118 -118 -118 -118 -118 -118 -118 -118 -118 -118 -118 -118 -118 -118 -118 -118 -118 -118 -118 -118 -118 -118 -127 -118 -118 -118 -118 -118 -118 -118 -118 -118 -118 -118 -118 -118 -118 -118 -118 -127 -127 -118 -118 -118 
-118 -118 -118 -118 -118 -118 -118 -118 -118 -118 -118 -118 -118 -118 -118 -118 -118 -118 -118 -118 -118 -127 -118 -118 -118 -118 -118 -118 -118 -118 -118 -118 -118 -118 -118 -118 -118 -118 -118 -118 -118 -118 -118 -118 -118 -118 -118 -118 -118 -118 -118 -118 -127 -118 -118 -118 -118 -118 -118 -118 -118 -118 -118 -118 
-118 -118 -118 -118 -118 -118 -118 -118 -118 -118 -118 -118 -118 -127 -118 -118 -118 -118 -118 -118 -118 -118 -118 -118 -118 -118 -118 -118 -118 -118 -118 -127 -118 -127 -118 -118 -127 -118 -118 -118 -127 -118 -118 -118 -118 -118 -118 -118 -118 -118 -118 -118 -118 -118 -118 -118 -118 -118 -118 -118 -118 -118 -118 -118 
-118 -127 -118 -118 -118 -118 -118 -118 -127 -118 -118 -118 -118 -118 -118 -118 -118 -118 -127 -118 -118 -118 -118 -118 -118 -118 -118 -118 -118 -118 -118 -118 -118 -118 -118 -118 -118 -118 -118 -118 -118 -118 -118 -118 -118 -118 -118 -118 -118 -118 -118 -118 -118 -118 -118 -118 -118 -118 -118 -118 -118 -127 -118 -118 
-118 -118 -118 -118 -118 -118 -118 -118 -118 -118 -127 -118 -118 -118 -118 -118 -118 -118 -118 -118 -118 -118 -118 -118 -118 -118 -118 -118 -118 -118 -118 -118 -118 -118 -118 -118 -118 -118 -118 -118 -118 -118 -118 -118 -118 -118 -118 -118 -118 -118 -118 -118 -118 -118 -118 -118 -118 -118 -118 -118 -118 -118 -118 -118 
-118 -118 -118 -118 -118 -118 -127 -118 -118 -118 -118 -118 -118 -118 -118 -118 -118 -118 -118 -118 -118 -118 -118 -118 -118 -118 -118 -118 -127 -118 -118 -118 -118 -118 -118 -118 -118 -118 -118 -118 -118 -118 -118 -118 -118 -118 -127 -127 -118 -118 -118 -118 -118 -118 -118 -118 -118 -118 -118 -118 -118 -118 -118 -118 
-118 -118 -118 -118 -118 -118 -127 -118 -118 -118 -127 -127 -118 -118 -118 -118 -118 -118 -118 -118 -118 -118 -118 -127 -118 -127 -118 -118 -118 -118 -118 -118 -118 -118 -118 -118 -118 -118 -118 -118 -118 -118 -118 -118 -118 -118 -118 -118 -118 -118 -118 -127 -118 -118 -118 -118 -118 -118 -118 -118 -118 -118 -118 -118 
-118 -118 -118 -118 -118 -118 -118 -118 -118 -118 -118 -118 -118 -118 -118 -127 -118 -118 -118 -118 -118 -118 -118 -118 -118 -118 -118 -118 -118 -118 -118 -118 -118 -118 -118 -118 -118 -118 -118 -118 -118 -127 -118 -118 -118 -118 -118 -118 -118 -118 -118 -118 -127 -118 -118 -127 -118 -118 -127 -118 -118 -127 -118 -118 
-118 -118 -118 -127 -118 -118 -118 -118 -118 -118 -118 -118 -118 -118 -118 -118 -118 -118 -118 -118 -118 -118 -118 -118 -118 -118 -118 -118 -118 -118 -118 -127 -118 -118 -118 -118 -118 -118 -118 -118 -118 -118 -118 -127 -118 -118 -118 -118 -127 -118 -118 -118 -118 -118 -118 -118 -118 -118 -118 -118 -118 -118 -118 -118 
-118 -118 -118 -118 -118 -118 -118 -118 -118 -118 -118 -118 -118 -127 -118 -118 -118 -118 -118 -118 -118 -127 -118 -118 -118 -118 -127 -118 -118 -127 -118 -118 -118 -118 -118 -118 -118 -118 -118 -118 -118 -118 -118 -118 -127 -118 -118 -118 -118 -118 -118 -118 -118 -118 -127 -118 -118 -118 -118 -118 -118 -118 -118 -118 
-118 -118 -127 -118 -118 -118 -118 -118 -118 -118 -118 -118 -118 -118 -118 -118 -118 -118 -118 -118 -118 -118 -118 -118 -118 -118 -118 -118 -118 -118 -118 -118 -118 -118 -118 -118 -118 -118 -118 -118 -118 -118 -118 -118 -118 -118 -118 -118 -118 -118 -118 -118 -118 -118 -118 -118 -118 -118 -118 -118 -118 -118 -118 -118 
-118 -118 -118 -118 -118 -118 -118 -127 -118 -118 -118 -118 -118 -118 -118 -118 -118 -127 -118 -118 -118 -118 -118 -118 -118 -118 -118 -118 -118 -118 -118 -118 -118 -118 -118 -118 -118 -118 -118 -118 -118 -118 -127 -118 -118 -127 -118 -118 -118 -118 -118 -118 -118 -118 -118 -118 -118 -118 -118 -118 -118 -118 -118 -118 
