64 64

0000000000000000000000000000000000000000000000000000000000000000
0111111111111111111111111111111111111111111111111111111111111110
0111111111111111111111111111111111111111111111111111111111111110
0111111211111111110000110001111111111111111111211111111111111110
0111111111111111110111111101111111111111111111111111111111111110
0111111111111111111111111111111111111111110111111111111111111110
0111111111111111111111111111111111111111101111111111111111111110
0111111111111111111111111111111111110001101111111111111111111110
0111111111111111110111111101111111111000001111111111111211111110
0111111111111111110111111001111111111000000111111111111111111110
0111111111111111111011111011111111111000000001111111111111111110
0111111111111111111111111111111111111100000111111111111111111110
0111111111111111111111111111111111111100011111111111000010001110
0111111111111111111111111111111111111101111111111111011111111110
0111111110111111111111111111111111111111111111111111011111111110
0111111110011001111111111111111111111111111111111111111111111110
0111111111101001111111111111111111112111111111111111111111111110
0111111111210000111111111111111111111111111111111111011111111110
0111111111110000111111111111111111111111111111111111011111111110
0111111111100000111111111111111111111111111111111111000110001110
0111111111111111111111111111111111111111111111111111111111111110
0111111111111111111111111111100001111111111111111111111111111110
0111111111111111111111111111001100011111111111111111111111111110
0111111111111111111111111111011111111111111111111111111111111110
0111111111111111111111111110111111111110001111111111211111111110
0111111111111111111111111111111111111111110111111111111111111110
0111111111111111111111111111111121111111110111111111111111111110
0111111111111111111111111111111111111111110111111111011111111110
0110110110001111111111110111111111111111110111111110011111111110
0110111111101111111111101111111101111111111111111100011111111110
0111111121111111111111001111111000111111111111110000011111111110
0111111111111111111111011111111000011111111111110000000110011110
0111111111111111111111001111111100111111111111111000011111111110
0110111111101111111111101111111111111111111111111100011111111110
0110111110001111111111110111111111111111110111111111011111111110
0111111111111111111111111111111111111111110111111111111121111110
0111111111111111111111111111111111111111110111111111111111111110
0111111111111111111111111111111111111111110111111111111111111110
0111111111111111111111111110111111111110001111111111111111111110
0111111111111111111111111111011111111101111111111111111111111110
0111111111111111111111111111001110011111111111111111111111111110
0111111111111111111111111111100001111111111111111111111111111110
0111111111100000011111111111111111111111111111111111111111111110
0111111111100000011111111111111111111111111111111111000110001110
0111111111110000011111211111111111111111111111111111011111111110
0111111111110000011111111111111111111111111111111111011111111110
0111111111101100111111111111111111111111111111111111111121111110
0111111110011110111111111111111111111111111111111111111111111110
0111111100111111111111111111111111111111111111111111011111111110
0111111111111111111111111111111111111000111111111111011111111110
0111111111111111111111111111111111111000000111111111000111001110
0111111111111111111111111111111111111000000111111111111111111110
0111111111111111111011111011111111111000011111111111111111111110
0111111111111111110111111001111111111000011111111111111111111110
0111111111111111110111111101111111110011011111111111111111111110
0111111111111111111111111111111111111111101111111111111111111110
0111111111111111111111111111111111111111100111211111111111111110
0111111111111111110111111101111111111111110111111111111111111110
0111111111111111110111111101111111111111111111111111111111111110
0111111111111111110001101001111111111111111111111111111111111110
0111111111111111111111111111111111111111111111111111111111111110
0111111111111111111111111111111111111111111111111111111111111110
0111111111111111111111111111111111111111111111111111111111111110
0000000000000000000000000000000000000000000000000000000000000000

0000000000000000000000000000000000000000000000000000000000000000
0111111111111111111111111111111111111111111111111111111111111110
0111111111111111111111111111111111111111111111111111111111111110
0111111111111111110000110001111111111111111111111111111111111110
0111111111111111110111111101111111111111111111111111111111111110
0111111111111111111111111111111111111111110111111111111111111110
0111111111111111111111111111111111111111101111111111111111111110
0111111111111111111111111111111111110001101111111111111111111110
0111111111111111110111111101111111111000001111111111111111111110
0111111111111111110111111001111111111000000111111111111111111110
0111111111111111111011111011111111111000000001111111111111111110
0111111111111111111111111111111111111100000111111111111111111110
0111111111111111111111111111111111111100011111111111000010001110
0111111111111111111111111111111111111101111111111111011111111110
0111111110111111111111111111111111111111111111111111011111111110
0111111110011001111111111111111111111111111111111111111111111110
0111111111101001111111111111111111111111111111111111111111111110
0111111111110000111111111111111111111111111111111111011111111110
0111111111110000111111111111111111111111111111111111011111111110
0111111111100000111111111111111111111111111111111111000110001110
0111111111111111111111111111111111111111111111111111111111111110
0111111111111111111111111111100001111111111111111111111111111110
0111111111111111111111111111001100011111111111111111111111111110
0111111111111111111111111111011111111111111111111111111111111110
0111111111111111111111111110111111111110001111111111111111111110
0111111111111111111111111111111111111111110111111111111111111110
0111111111111111111111111111111111111111110111111111111111111110
0111111111111111111111111111111111111111110111111111011111111110
0110110110001111111111110111111111111111110111111110011111111110
0110111111101111111111101111111101111111111111111100011111111110
0111111111111111111111001111111000111111111111110000011111111110
0111111111111111111111011111111000011111111111110000000110011110
0111111111111111111111001111111100111111111111111000011111111110
0110111111101111111111101111111111111111111111111100011111111110
0110111110001111111111110111111111111111110111111111011111111110
0111111111111111111111111111111111111111110111111111111111111110
0111111111111111111111111111111111111111110111111111111111111110
0111111111111111111111111111111111111111110111111111111111111110
0111111111111111111111111110111111111110001111111111111111111110
0111111111111111111111111111011111111101111111111111111111111110
0111111111111111111111111111001110011111111111111111111111111110
0111111111111111111111111111100001111111111111111111111111111110
0111111111100000011111111111111111111111111111111111111111111110
0111111111100000011111111111111111111111111111111111000110001110
0111111111110000011111111111111111111111111111111111011111111110
0111111111110000011111111111111111111111111111111111011111111110
0111111111101100111111111111111111111111111111111111111111111110
0111111110011110111111111111111111111111111111111111111111111110
0111111100111111111111111111111111111111111111111111011111111110
0111111111111111111111111111111111111000111111111111011111111110
0111111111111111111111111111111111111000000111111111000111001110
0111111111111111111111111111111111111000000111111111111111111110
0111111111111111111011111011111111111000011111111111111111111110
0111111111111111110111111001111111111000011111111111111111111110
0111111111111111110111111101111111110011011111111111111111111110
0111111111111111111111111111111111111111101111111111111111111110
0111111111111111111111111111111111111111100111111111111111111110
0111111111111111110111111101111111111111110111111111111111111110
0111111111111111110111111101111111111111111111111111111111111110
0111111111111111110001101001111111111111111111111111111111111110
0111111111111111111111111111111111111111111111111111111111111110
0111111111111111111111111111111111111111111111111111111111111110
0111111111111111111111111111111111111111111111111111111111111110
0000000000000000000000000000000000000000000000000000000000000000