0 -128 91 -6 15 -52 15 -18 74 91 -6 31 -18 47 31 -78 -64 74 -111 74 -64 -78 47 74 0 60 15 -111 -111 15 60 0 74 47 -78 -64 74 -111 74 -64 -78 31 60 -18 31 0 91 91 -6 15 -35 15 -6 -128 -128 15 60 0 91 60 -52 -18 -111 -52 
-78 15 -64 -78 -35 60 0 -6 47 -64 -111 -95 -18 -128 60 91 -52 91 74 -128 -18 -78 -95 -35 74 15 31 91 -6 -52 -18 60 -18 -52 -18 74 0 -6 47 -78 91 -128 -64 60 15 31 -111 15 -6 15 -111 47 31 74 -52 -111 -111 -52 74 15 31 -111 15 -6 
74 -128 -35 91 31 15 60 -78 47 -6 -6 15 -128 15 -35 -35 0 -128 0 -35 -35 0 -128 15 -18 -18 31 -95 47 0 15 60 -52 91 47 60 -111 0 -78 -111 -95 -18 74 0 -18 -6 60 -52 -128 74 -128 -52 60 -6 -18 -6 60 -35 -111 -128 -95 -6 -128 47 
-64 74 74 -52 -111 -52 74 60 -78 91 -111 15 0 74 0 15 -95 -128 -64 91 -128 -18 -64 -18 -111 -111 -6 -64 -18 -128 91 -52 -128 -95 31 0 74 0 15 -95 91 -78 74 74 -52 -95 -52 91 91 -52 -111 -78 47 31 -128 47 74 -35 -64 -6 -78 -64 31 0 
-111 -128 60 -35 60 -111 -95 -128 47 -52 31 91 91 60 0 -111 -18 15 15 -18 -95 15 91 -95 -111 74 0 -128 -52 -18 -35 -95 47 -78 -18 0 -6 -78 60 -78 -18 -6 -35 -111 15 -128 -68 -64 -95 60 -52 15 60 61 15 -52 47 -111 -78 -78 -128 15 -111 -52 
47 -6 47 0 74 31 -128 74 -78 -95 -6 -18 60 60 -64 -64 31 47 -64 -64 60 74 -6 0 -78 -52 -128 -95 60 -128 47 91 31 91 47 -128 60 -95 -128 -52 -78 0 -6 74 68 -58 -48 41 41 -78 -64 48 61 -33 -17 -110 -78 60 91 15 60 -6 31 -18 
-35 -35 74 60 -64 -111 -35 -95 -35 -128 -95 47 47 -64 -95 0 -35 31 -18 15 -64 -35 91 91 -35 -52 31 -6 47 -6 31 -52 -18 91 91 -35 -52 15 -18 31 -18 0 -78 -42 78 78 -38 -75 0 -58 -6 -76 -50 94 -126 -5 -17 74 47 -111 60 -111 47 74 
74 60 -35 15 -6 -128 -95 74 -52 -35 -95 -18 -18 -111 -52 -64 47 91 60 -64 -35 -95 -6 0 -64 0 -6 -111 -52 -78 47 74 31 -95 -78 91 -64 -52 91 -78 -95 31 74 56 -48 -5 -57 28 18 -58 16 0 -75 -4 -49 76 -110 74 -52 -35 -95 -6 -6 -78 
-95 -95 -78 -52 0 74 -64 31 -64 74 0 -52 -78 -95 -95 -64 -35 15 91 -35 60 -35 -128 47 0 -35 -35 -35 -6 31 91 -64 31 -78 47 -35 -95 91 60 60 60 91 -85 0 71 -43 77 -12 -98 52 10 -5 -4 6 29 71 -93 -6 91 -18 -111 47 -6 -52 
-128 0 91 -128 74 0 91 -95 -111 47 -64 -18 -6 -64 47 -111 -95 91 0 91 -111 91 0 -128 -78 -95 74 -35 15 15 -35 91 -64 -52 -78 60 -78 -52 -78 74 -52 -6 -6 -58 64 -98 -88 88 -15 41 69 53 -29 64 81 64 -7 74 -95 -95 74 -35 15 31 
0 -95 -18 -18 -95 -6 0 -35 74 -111 -128 15 91 91 15 -111 -78 -128 0 47 31 -35 31 47 -6 91 -95 91 -6 60 47 -18 60 74 15 -95 -52 -78 60 -95 -95 60 -78 -42 -75 35 104 78 0 56 57 4 123 -68 123 1 42 31 -52 31 47 -6 -128 -95 
-111 -35 0 31 31 15 -35 -111 15 -111 -18 31 60 60 31 -6 -78 60 -64 15 74 -128 -111 -128 60 -6 -111 0 91 -64 -35 -18 -35 -78 91 0 -111 -18 31 74 91 91 47 -6 -85 25 -91 -25 8 26 19 6 -41 127 4 89 -75 -42 -18 -18 -52 -111 47 -64 
-111 74 -111 -6 -52 -18 91 31 60 -64 -111 -95 0 -52 -18 60 0 15 -111 47 60 -78 91 91 -52 -128 -111 -35 -111 -111 -18 -111 -111 -35 -128 -128 -52 91 74 -78 60 47 -128 15 0 60 -25 -52 0 -93 -116 -45 90 70 105 0 -42 -6 -128 74 -111 0 -35 0 
31 60 91 -111 -78 -35 0 47 91 -78 -18 31 91 -64 0 74 -64 0 91 -52 47 -95 0 -128 -6 91 -18 91 -6 -128 0 -95 47 -52 91 15 -64 91 0 -52 -128 47 -6 -64 -128 60 15 -18 -64 -93 -115 98 64 63 36 18 0 -6 -6 -6 -6 0 15 31 
0 0 0 -18 -52 -95 74 15 -52 91 -6 -111 0 -128 -35 31 -128 -64 -6 15 47 60 60 60 47 15 -18 -64 -128 31 -52 91 -18 91 -18 60 -78 -6 47 -128 -78 -52 -35 -18 -18 -35 -64 -94 76 18 -31 -113 29 -59 43 -67 15 -128 -52 15 74 -111 -78 -52 
31 47 91 -64 47 -52 -111 -128 -128 -78 -6 -128 0 -52 -78 -78 -35 31 -95 31 -18 -64 -64 -18 31 -95 31 -35 -64 -64 -35 15 -111 15 -52 -95 -111 -78 -18 74 -35 -111 74 60 91 -78 0 -111 48 0 -5 2 49 -83 16 -52 -111 -128 -111 -64 15 -95 47 -6 
-78 60 -111 74 -64 -64 60 91 15 91 60 -64 -64 74 -128 47 -95 -128 -6 0 -64 -18 -64 15 0 -95 -64 91 -78 -111 -18 -6 -111 -78 91 -64 -75 15 31 -52 -6 -52 31 15 -95 -64 91 -78 -127 -16 -33 94 -93 61 -94 -128 -6 -6 -95 -52 -111 -18 -35 74 
-35 91 60 91 -52 91 74 -128 -18 -78 -95 -35 74 15 31 -128 0 -35 -6 60 -18 -35 -6 91 15 0 60 -52 -111 -111 -52 74 31 60 -92 50 21 50 -75 74 60 -128 -18 -78 -78 -18 -128 60 74 -77 61 17 48 -77 60 47 91 -35 -95 -95 -35 74 31 31 
31 -64 -111 -128 -78 15 -78 -128 91 -78 0 -78 -128 -128 -78 15 -64 -111 -111 -52 47 -35 -78 -64 -6 91 0 -18 -6 47 -78 74 47 62 -105 4 -58 -89 -72 -3 -128 31 15 31 -128 -6 -64 -95 -64 0 -95 61 47 74 -64 47 -6 -18 15 91 -6 -64 -64 -35 
47 -95 74 -128 -6 -18 47 -18 -6 -128 60 -111 47 47 -78 -128 -64 60 60 -78 91 -95 31 15 91 31 60 -52 -78 -6 -95 -78 31 -3 53 -26 -6 67 21 62 -35 -35 47 -6 15 -78 -95 -18 -95 -64 31 0 74 -6 0 -128 74 -111 31 31 -111 74 -111 15 
-18 -64 60 -64 -6 0 -6 -64 60 -78 -35 -18 -52 -128 0 91 -95 -95 -128 15 -95 -6 15 15 -18 -111 0 74 -128 91 31 -52 50 -122 -86 -99 73 -23 67 -122 -108 -128 31 -64 15 60 74 47 -18 91 -64 -18 -18 -64 91 -18 47 74 74 15 -64 47 -128 -95 
47 -128 47 -111 74 -78 -111 -35 -64 15 0 -128 74 -35 -52 60 60 -52 -52 74 91 -6 0 -78 -52 91 -95 47 91 15 74 15 60 18 80 40 -116 67 -89 -125 -35 -64 15 0 -128 91 -18 -35 74 74 -18 -6 -111 -95 31 60 -18 0 -78 -35 -111 -64 -128 -78 
74 -35 -35 60 31 -111 74 -95 60 91 0 15 -95 -95 -6 -35 47 -6 47 -18 0 -95 -78 31 15 -111 74 -78 -128 -78 74 -128 0 18 -105 -122 -23 -61 4 -49 -6 -95 -64 60 60 -52 -78 0 -18 31 -18 15 -64 -52 74 74 -52 -64 15 -35 31 -35 0 -78 
0 -128 -95 74 -52 -52 -128 -52 -64 74 -95 -128 -6 31 -6 91 -128 47 -95 -95 47 -111 -128 0 47 15 -111 -78 -128 -35 -18 -95 -6 -18 -105 -46 -55 53 97 47 -78 -52 -111 -18 -18 -95 -18 -35 91 -78 -111 0 31 -6 74 -128 31 -128 -128 15 91 60 -35 0 
-64 31 -95 31 -52 -128 60 15 0 15 31 74 -95 -18 60 -52 74 -6 -64 -111 91 74 74 -128 -78 -18 60 -78 31 -52 91 31 -6 -32 -46 -29 2 37 -122 -32 60 -52 74 0 -52 -95 -111 -128 -111 -64 -18 47 -95 0 -111 31 -35 -95 -128 91 91 -128 -95 -35 
74 -64 -35 -52 -128 -6 31 31 -18 91 -64 -52 -95 31 -111 -78 -111 31 -95 -64 -78 91 -35 15 15 -18 91 -64 -52 -95 47 -95 -64 -92 64 -69 -6 -26 -105 1 60 74 15 -78 -6 0 -18 -111 -18 0 -6 -78 15 60 47 -6 -128 -52 -52 -95 31 -128 -95 -128 
60 -128 60 -52 0 -6 -95 -6 0 -52 47 91 60 -35 15 0 -64 15 47 -6 -128 -78 -111 31 -128 -128 31 -95 -78 -128 0 47 34 -46 24 43 -3 86 -119 80 -32 15 15 -64 15 31 -18 91 -95 -128 0 74 60 -6 91 -128 60 -52 -6 -18 -111 -35 -35 -95 
47 -18 -128 -18 60 -111 -78 -78 -95 92 15 -78 31 -111 -52 -18 -6 -18 -64 91 0 -111 -18 31 74 74 74 31 -18 -128 -6 91 -78 -32 -12 -9 -55 -119 21 -75 0 74 -111 -78 -95 -128 47 -18 91 -35 31 74 -128 -128 74 15 -52 74 -52 15 74 -128 -128 74 
-35 -95 -64 31 -18 0 91 32 48 -76 92 92 -35 -111 -95 -6 -78 -78 0 -64 -64 15 -64 -64 0 -64 -78 -6 -78 -95 -18 -111 -128 -64 80 64 -102 21 4 62 -35 -52 -6 -111 91 -78 47 0 60 -52 -78 -35 74 31 74 -35 -78 -35 60 15 47 -64 -128 -95 
-18 31 91 -78 -18 47 -110 -33 49 -108 -16 76 -64 31 -95 0 -128 -6 -128 -6 -111 0 -95 47 -52 91 0 -78 60 -6 -78 74 15 -52 -108 77 21 -15 -64 -111 74 47 15 -6 -18 -52 -64 -64 -78 -78 -78 -78 -78 -64 -52 -35 -6 0 31 74 -128 -78 -35 0 
-18 -111 15 -95 15 -111 -17 49 -108 -48 -5 17 48 60 60 47 31 0 -35 -94 74 0 -78 47 -52 60 -64 15 -128 -52 0 47 91 -111 -95 -95 -92 -111 91 47 0 -52 -128 15 -64 60 -52 47 -78 0 74 -95 -35 0 31 47 60 60 47 15 -6 -52 -111 47 
74 -95 -18 91 0 -34 -64 -49 -5 79 -48 94 33 16 15 60 -95 17 -77 93 61 75 -128 -52 47 -35 -111 91 91 -95 -35 60 -35 -95 91 91 -111 -35 47 -52 -128 74 60 91 -78 15 -95 60 15 15 31 91 -52 74 -6 -52 -64 -35 0 91 -18 -95 74 60 
-78 -35 -95 -6 -35 74 92 17 62 19 -125 -126 -6 15 -52 16 -16 78 94 -5 33 -33 48 15 -95 -95 60 -128 60 -95 -95 15 47 -18 31 -6 91 91 -6 15 -35 31 0 -128 -111 31 74 15 -128 91 -18 -6 -78 -18 -64 15 15 -78 -52 -128 -52 -78 15 15 
-95 -95 -18 -128 60 74 -64 76 49 77 -50 -126 92 -95 16 -33 -32 20 -73 97 -107 -33 92 60 91 -35 -128 91 -95 15 -52 -52 0 -95 74 91 -64 60 31 60 -78 60 47 91 -35 -111 -111 -52 60 0 15 91 -6 -52 -18 47 -12 -52 -6 74 0 0 47 -64 
60 -111 -6 -95 -128 -111 -52 61 -17 -50 -17 32 -78 74 48 62 -90 22 -45 -61 -47 18 -76 75 60 91 -64 47 -6 -18 0 91 -18 -78 -95 -52 31 -64 -128 91 -95 -6 -111 74 60 -128 -34 -128 60 60 -128 -35 -128 60 64 -105 -6 -105 80 91 -78 0 -64 -111 
-6 60 0 15 -95 -128 -52 91 -128 -17 -52 -6 -95 -94 0 -49 -4 -88 -104 -11 -90 -49 61 47 -128 47 60 -52 -78 -18 -111 -95 0 -35 0 -78 -78 0 -52 -6 -111 -128 -52 -111 -77 32 0 75 0 15 -111 91 -78 64 70 -56 -93 -56 70 64 -78 91 -111 15 
-78 -111 47 -64 0 47 31 0 -78 15 91 -111 -111 60 -17 76 -74 -62 -73 96 -5 93 -77 -64 -95 74 -18 60 -128 -111 91 15 -95 -6 15 15 -6 -95 15 91 -95 -111 74 -6 -126 -64 -32 -50 -109 32 -95 -35 -18 -29 -83 49 -87 -34 -40 -62 91 -18 60 -128 
31 31 -78 -64 60 74 -6 15 -64 -35 -128 -78 74 -111 61 -126 49 -107 62 -91 93 -64 -95 -18 -52 47 15 -111 -128 -18 -18 74 74 -35 -18 -128 -111 15 31 -52 -18 -111 -64 92 -93 62 -124 49 -126 48 -111 74 -72 -116 -34 -57 28 2 92 59 -72 -78 15 15 
31 91 31 74 -6 0 -111 -111 -6 -18 47 0 60 -6 31 -64 -51 76 61 -64 -95 -18 -64 -6 -78 -52 91 91 -18 -18 60 31 -128 47 -128 31 60 -35 -35 74 60 -64 -110 -33 -92 -48 -123 -107 34 33 -94 -111 -18 -62 10 -34 6 -77 -56 53 47 -64 -95 -6 
-35 15 0 -111 -64 -111 0 31 -35 60 60 -6 60 47 -52 0 -18 92 -111 74 -52 -35 -111 -18 -18 -111 -52 -64 60 -128 74 -52 -18 -78 15 15 -52 15 15 -78 -18 -52 74 -110 61 -49 -31 -92 -5 -6 -95 -18 -35 97 -83 -116 0 27 -23 64 74 0 74 74 
91 -128 -95 -52 0 91 -52 60 -18 -111 60 15 -6 -6 0 31 74 -78 -6 91 -6 -111 47 -6 -52 -64 -64 -52 -18 31 91 -52 60 -52 91 15 -35 -64 -78 -78 -64 -17 15 92 -33 61 -32 -126 33 -6 -35 -51 -52 -18 4 64 -60 4 -105 15 -64 -128 60 31 
-78 15 74 74 15 -95 -18 -6 -52 74 -64 -35 -64 74 -52 -6 -18 -78 15 74 74 31 -78 -6 0 -18 -128 -35 -6 -18 -111 -6 31 31 -35 74 -95 -78 91 -6 61 93 48 -34 48 92 61 -6 92 -77 -93 76 -34 32 40 0 -87 -9 0 -35 -128 -18 0 -6 
15 0 -78 0 0 -52 47 91 47 -52 0 0 -78 0 15 -18 74 -111 91 0 60 60 -6 74 -128 60 -52 -6 -18 -111 -35 -35 -95 0 31 -6 -111 -52 -64 76 -64 -49 -109 -5 32 0 -94 -35 -33 -108 -14 -5 -49 69 -109 92 8 62 76 0 91 -128 74 -35 
60 -95 -64 -52 -52 -95 74 -6 -128 -35 31 74 91 74 47 -6 -95 31 -111 -35 0 31 15 -6 -64 91 -6 74 -64 -18 0 0 -18 -78 74 -18 74 -78 -17 0 1 -5 -64 93 -6 -128 -52 0 49 50 37 -4 -73 57 -49 42 110 -101 -93 -119 60 -6 -95 15 
0 0 74 -6 -6 47 -35 -35 15 -64 -78 -18 -111 91 -78 60 31 91 -6 -35 0 -95 -128 -78 47 15 60 -52 -95 -52 60 15 60 -52 -95 -64 31 -6 17 -108 78 -123 -14 -75 -64 32 -18 -5 95 37 53 -87 73 96 -39 128 -83 -16 -101 -93 -26 -111 -111 -35 
-6 -95 47 -35 -111 31 -35 -95 60 0 -52 -111 74 15 -6 -52 -95 -128 74 47 31 15 0 -6 -18 -18 -18 -6 -6 0 15 31 60 74 -128 -78 -52 -6 32 76 -92 -31 18 76 -94 -18 48 -109 -14 64 -70 6 -122 -22 78 -25 77 -41 62 -59 60 -52 91 -6 
-52 60 -64 15 -128 -64 -6 31 74 -128 -111 -111 -128 91 60 15 -35 -95 60 -18 -111 0 -111 -6 91 -52 15 74 -111 -64 -35 -18 -18 -18 -35 -64 -95 74 16 -33 -126 18 -76 33 -94 0 91 -64 -5 51 97 -105 -74 -66 -62 -62 -84 109 62 0 -78 74 -6 -111 
91 0 -52 -64 -64 -18 47 -64 60 0 -6 -6 31 -128 -18 -128 47 15 15 47 -111 -6 -111 60 15 15 60 -111 -6 -111 47 0 0 31 91 -52 74 0 -35 -34 -17 33 -110 16 -52 -95 -111 -94 -33 49 -64 78 34 17 40 100 -50 55 -26 -78 -95 -95 -35 31 
60 47 -64 -35 -111 -52 -78 0 0 -95 -52 -111 -35 -64 31 47 -35 0 -52 31 15 -95 -64 74 -95 -128 -35 -35 91 -111 47 -111 91 -35 -18 -128 -78 91 -52 -64 47 61 -18 31 -6 74 60 -35 -6 -77 -5 -50 48 60 -35 0 -43 15 -6 -128 -111 31 91 31 
-64 -128 91 -78 31 -6 -6 60 -18 -64 -35 47 -35 -64 -18 74 0 -6 47 -64 -128 -128 -52 74 31 60 -95 47 15 60 -78 74 60 -111 -6 -64 -52 0 -95 91 -128 -52 91 60 91 -52 -128 91 -95 0 -51 -52 0 -95 74 91 -64 74 31 60 -78 74 47 91 
31 74 -64 74 15 15 60 -78 60 0 0 60 -78 60 15 15 74 -52 91 47 47 -128 -18 -111 91 -128 -64 31 -52 -78 -64 -6 -128 31 0 15 91 -35 -111 -128 -111 -35 74 0 -6 0 74 -18 -95 -111 -78 -6 -111 60 47 74 -78 47 -6 -18 15 -128 0 -52 
47 -52 -64 0 -52 -35 74 60 -111 47 60 -64 -111 -52 91 91 -35 -95 -52 74 74 -64 -128 -95 15 0 74 0 15 -95 -128 -64 91 91 -35 -64 -18 -111 -111 -18 -78 -35 91 74 -64 91 -111 15 -6 60 -6 0 -128 74 -95 47 60 -78 -128 -78 60 60 -78 91 
-35 0 0 -35 -111 0 74 -128 -128 60 -18 74 -78 -52 -64 -111 15 -111 -52 -18 -52 -111 15 -111 -64 -52 -78 91 -6 60 -111 -111 91 15 -95 -18 15 15 -18 -111 0 74 -128 91 47 -35 60 -111 -78 -95 74 -18 74 -95 -78 -95 60 -35 47 -128 -128 74 0 -95 
-52 -52 74 91 -6 0 -95 -64 74 -111 31 74 0 47 -6 47 -6 47 0 60 15 -128 60 -78 -111 -18 -35 60 47 -78 -78 15 31 -78 -78 47 60 -18 -6 -95 -64 74 -111 47 91 15 74 0 60 15 74 31 -128 60 -78 -111 -18 -52 47 15 -111 -111 -6 -6 
-52 0 -52 -18 -111 -95 31 15 -111 91 -52 -111 -52 -128 -95 47 60 -52 -64 31 0 74 15 74 0 31 -64 -52 60 47 -95 -128 -64 -128 -64 74 -128 0 15 -111 -128 -35 -64 -6 -64 -18 -111 -78 47 47 -78 -95 -6 -52 0 -52 -6 -95 -78 47 47 -78 -111 -18 
31 -128 91 -6 47 0 -111 -64 -128 -18 -6 -78 -6 -6 -95 -35 -52 60 -128 74 -52 -18 -78 0 0 -64 0 -6 -95 -35 -64 47 74 31 -95 -78 91 -64 -64 74 -78 -95 31 74 31 -78 -52 -111 -6 -6 -78 0 -6 -95 -35 -64 47 91 47 -78 -52 -128 -35 -18 
-78 -95 -95 -64 -35 15 91 -35 60 -35 -128 47 -6 -35 -52 -52 -18 15 74 -78 15 -95 31 -52 -111 74 47 31 47 74 -111 -52 31 -95 15 -78 74 0 -18 -52 -52 -52 -18 31 91 -52 47 -52 74 0 -52 -78 -111 -111 -95 -52 -6 60 -78 15 -78 60 -6 -64 
60 15 -95 -18 0 -35 -128 -35 -6 -35 -111 -6 31 15 -35 74 -95 -78 91 -6 74 91 60 -18 60 91 74 0 -128 -64 -78 91 -18 47 60 0 -78 -6 15 -6 -95 -6 31 15 -52 60 -128 -128 47 -52 15 31 -6 -111 -18 0 -18 -111 -6 31 15 -35 60 -111 
0 0 -64 15 31 -6 -128 -78 -111 31 -128 -128 47 -95 -64 -111 15 74 47 -18 47 60 0 -128 -95 -128 0 60 47 -18 60 74 31 -95 -52 -78 60 -111 -111 60 -78 -52 -95 15 60 47 -35 31 31 -18 74 -128 74 -35 15 0 -64 0 15 -18 74 -111 91 -6 
15 47 47 15 -18 -95 31 -78 0 60 91 91 74 31 -35 -128 -18 60 -95 -64 -52 -64 -111 47 -35 74 -64 0 47 60 47 0 -52 91 -18 74 -78 -52 -18 -35 -64 -128 15 -78 0 74 -95 -78 -78 -111 60 -18 -128 -18 47 -128 -95 -95 -128 47 -18 -128 -18 60 
47 -78 91 -128 -18 -78 -52 31 -18 -6 74 15 31 -111 47 60 -95 60 74 -78 74 74 -64 74 74 -78 60 60 -95 47 31 -128 0 -6 60 -35 -52 0 -95 -111 -52 74 47 -128 0 -18 15 -95 -128 -78 47 0 47 -64 -111 -64 47 0 31 -78 91 -111 0 -52 
31 91 -78 -18 47 -111 -35 31 -111 -35 47 -78 0 -128 -18 91 -35 74 -35 74 -18 -128 0 -95 47 -35 -128 15 -52 -128 31 -35 -95 60 0 -35 -95 91 47 15 -18 -52 -78 -111 -128 91 74 60 60 60 60 60 74 91 -128 -111 -78 -64 -35 0 31 74 -111 -52 
74 -18 -128 -6 91 -35 47 -111 -52 -6 31 60 74 91 91 74 47 0 -35 -95 60 -6 -95 31 -78 15 -111 -18 47 -111 -52 -6 15 31 47 47 31 15 -6 -52 -111 47 -18 -111 15 -78 31 -95 -6 60 -95 -35 0 47 74 91 91 74 60 31 -6 -52 -111 47 
-95 -35 60 -35 -111 91 74 -128 -52 31 -64 91 47 47 60 -111 -6 -128 31 -6 -18 0 47 -95 31 -52 -95 -111 -95 -35 31 -78 74 15 0 15 60 -78 15 -64 -111 91 -128 -78 -6 -128 0 -52 -64 -64 -18 47 -78 60 -6 -35 -18 0 74 -52 74 15 -18 -18 
