22 -127 122 5 39 -44 39 -10 105 122 5 55 -10 72 55 -77 -60 105 -110 105 -60 -77 72 105 22 89 39 -110 -110 39 89 22 105 72 -77 -60 105 -110 105 -60 -77 55 89 -10 55 22 122 122 5 39 -27 39 5 -127 -127 39 89 22 122 89 -44 -10 -110 -44 
-77 39 -60 -77 -27 89 22 5 72 -60 -110 -94 -10 -127 89 122 -44 122 105 -127 -10 -77 -94 -27 105 39 55 122 5 -44 -10 89 -10 -44 -10 105 22 5 72 -77 122 -127 -60 89 39 55 -110 39 5 39 -110 72 55 105 -44 -110 -110 -44 105 39 55 -110 39 5 
105 -127 -27 122 55 39 89 -77 72 5 5 39 -127 39 -27 -27 22 -127 22 -27 -27 22 -127 39 -10 -10 55 -94 72 22 39 89 -44 122 72 89 -110 22 -77 -110 -94 -10 105 22 -10 5 89 -44 -127 105 -127 -44 89 5 -10 5 89 -27 -110 -127 -94 5 -127 72 
-60 105 105 -44 -110 -44 105 89 -77 122 -110 39 22 105 22 39 -94 -127 -60 122 -127 -10 -60 -10 -110 -110 5 -60 -10 -127 122 -44 -127 -94 55 22 105 22 39 -94 122 -77 105 105 -44 -94 -44 122 122 -44 -110 -77 72 55 -127 72 105 -27 -60 5 -77 -60 55 22 
-110 -127 89 -27 89 -110 -94 -127 72 -44 55 122 122 89 22 -110 -10 39 39 -10 -94 39 122 -94 -110 105 22 -127 -44 -10 -27 -94 72 -77 -10 22 5 -77 89 -77 -10 5 -27 -110 39 -127 -76 -60 -94 89 -44 39 89 90 39 -44 72 -110 -77 -77 -127 39 -110 -44 
72 5 72 22 105 55 -127 105 -77 -94 5 -10 89 89 -60 -60 55 72 -60 -60 89 105 5 22 -77 -44 -127 -94 89 -127 72 122 55 122 72 -127 89 -94 -127 -44 -77 22 5 105 90 -59 -58 56 56 -77 -60 73 90 -25 -9 -109 -77 89 122 39 89 5 55 -10 
-27 -27 105 89 -60 -110 -27 -94 -27 -127 -94 72 72 -60 -94 22 -27 55 -10 39 -60 -27 122 122 -27 -44 55 5 72 5 55 -44 -10 122 122 -27 -44 39 -10 55 -10 22 -77 -43 91 91 -57 -92 -8 -59 6 -75 -42 125 -125 7 -9 105 72 -110 89 -110 72 105 
105 89 -27 39 5 -127 -94 105 -44 -27 -94 -10 -10 -110 -44 -60 72 122 89 -60 -27 -94 5 22 -60 22 5 -110 -44 -77 72 105 55 -94 -77 122 -60 -44 122 -77 -94 55 105 73 -58 -24 -90 25 24 -59 40 24 -74 -5 -41 107 -109 105 -44 -27 -94 5 5 -77 
-94 -94 -77 -44 22 105 -60 55 -60 105 22 -44 -77 -94 -94 -60 -27 39 122 -27 89 -27 -127 72 22 -27 -27 -27 5 55 122 -60 55 -77 72 -27 -94 122 89 89 89 122 -93 -8 75 -73 60 -40 -124 58 25 -6 -5 12 44 93 -92 6 122 -10 -110 72 5 -44 
-127 22 122 -127 105 22 122 -94 -110 72 -60 -10 5 -60 72 -110 -94 122 22 122 -110 122 22 -127 -77 -94 105 -27 39 39 -27 122 -60 -44 -77 89 -77 -44 -77 105 -44 5 5 -59 74 -124 -123 92 -25 56 91 59 -39 62 94 76 -8 105 -94 -94 105 -27 39 55 
22 -94 -10 -10 -94 5 22 -27 105 -110 -127 39 122 122 39 -110 -77 -127 22 72 55 -27 55 72 5 122 -94 122 5 89 72 -10 89 105 39 -94 -44 -77 89 -94 -94 89 -77 -43 -92 41 108 91 -8 73 74 10 127 -103 127 -6 57 55 -44 55 72 5 -127 -94 
-110 -27 22 55 55 39 -27 -110 39 -110 -10 55 89 89 55 5 -77 89 -60 39 105 -127 -110 -127 89 5 -110 22 122 -60 -27 -10 -27 -77 122 22 -110 -10 55 105 122 122 72 5 -93 40 -108 -26 23 41 25 -4 -71 113 -22 93 -92 -43 -10 -10 -44 -110 72 -60 
-110 105 -110 5 -44 -10 122 55 89 -60 -110 -94 22 -44 -10 89 22 39 -110 72 89 -77 122 122 -44 -127 -110 -27 -110 -110 -10 -110 -110 -27 -127 -127 -44 122 105 -77 89 72 -127 39 22 89 -26 -44 23 -92 -124 -55 94 62 109 -8 -43 5 -127 105 -110 22 -27 22 
55 89 122 -110 -77 -27 22 72 122 -77 -10 55 122 -60 22 105 -60 22 122 -44 72 -94 22 -127 5 122 -10 122 5 -127 22 -94 72 -44 122 39 -60 122 22 -44 -127 72 5 -60 -127 89 39 -10 -59 -92 -123 111 77 60 42 24 6 5 5 5 5 22 39 55 
22 22 22 -10 -44 -94 105 39 -44 122 5 -110 22 -127 -27 55 -127 -60 5 39 72 89 89 89 72 39 -10 -60 -127 55 -44 122 -10 122 -10 89 -77 5 72 -127 -77 -44 -27 -10 -10 -27 -60 -93 107 42 -23 -121 44 -72 58 -75 39 -127 -44 39 105 -110 -77 -44 
55 72 122 -60 72 -44 -110 -127 -127 -77 5 -127 22 -44 -77 -77 -27 55 -94 55 -10 -60 -60 -10 55 -94 55 -27 -60 -60 -27 39 -110 39 -44 -94 -110 -77 -10 105 -27 -110 105 89 122 -77 22 -110 73 24 8 26 75 -91 40 -44 -110 -127 -110 -60 39 -94 72 5 
-77 89 -110 105 -60 -60 89 122 39 122 89 -60 -60 105 -127 72 -94 -127 5 22 -60 -10 -60 39 22 -94 -60 122 -77 -110 -10 5 -110 -77 122 -60 -77 39 55 -44 5 -44 55 39 -94 -60 122 -77 -126 -8 -25 125 -92 91 -93 -127 5 5 -94 -44 -110 -10 -27 105 
-27 122 89 122 -44 122 105 -127 -10 -77 -94 -27 105 39 55 -127 22 -27 5 89 -10 -27 5 122 39 22 89 -44 -110 -110 -44 105 55 89 -94 72 39 72 -77 105 89 -127 -10 -77 -77 -10 -127 89 105 -76 90 41 73 -76 89 72 122 -27 -94 -94 -27 105 55 55 
55 -60 -110 -127 -77 39 -77 -127 122 -77 22 -77 -127 -127 -77 39 -60 -110 -110 -44 72 -27 -77 -60 5 122 22 -10 5 72 -77 105 72 89 -110 22 -60 -94 -77 5 -127 55 39 55 -127 5 -60 -94 -60 22 -94 90 72 105 -60 72 5 -10 39 122 5 -60 -60 -27 
72 -94 105 -127 5 -10 72 -10 5 -127 89 -110 72 72 -77 -127 -60 89 89 -77 122 -94 55 39 122 55 89 -44 -77 5 -94 -77 55 5 72 -27 -10 89 39 89 -27 -27 72 5 39 -77 -94 -10 -94 -60 55 22 105 5 22 -127 105 -110 55 55 -110 105 -110 39 
-10 -60 89 -60 5 22 5 -60 89 -77 -27 -10 -44 -127 22 122 -94 -94 -127 39 -94 5 39 39 -10 -110 22 105 -127 122 55 -44 72 -127 -94 -110 89 -27 89 -127 -110 -127 55 -60 39 89 105 72 -10 122 -60 -10 -10 -60 122 -10 72 105 105 39 -60 72 -127 -94 
72 -127 72 -110 105 -77 -110 -27 -60 39 22 -127 105 -27 -44 89 89 -44 -44 105 122 5 22 -77 -44 122 -94 72 122 39 105 39 89 39 105 55 -127 89 -94 -127 -27 -60 39 22 -127 122 -10 -27 105 105 -10 5 -110 -94 55 89 -10 22 -77 -27 -110 -60 -127 -77 
105 -27 -27 89 55 -110 105 -94 89 122 22 39 -94 -94 5 -27 72 5 72 -10 22 -94 -77 55 39 -110 105 -77 -127 -77 105 -127 22 39 -110 -127 -27 -60 22 -44 5 -94 -60 89 89 -44 -77 22 -10 55 -10 39 -60 -44 105 105 -44 -60 39 -27 55 -27 22 -77 
22 -127 -94 105 -44 -44 -127 -44 -60 105 -94 -127 5 55 5 122 -127 72 -94 -94 72 -110 -127 22 72 39 -110 -77 -127 -27 -10 -94 5 -10 -110 -44 -60 72 122 72 -77 -44 -110 -10 -10 -94 -10 -27 122 -77 -110 22 55 5 105 -127 55 -127 -127 39 122 89 -27 22 
-60 55 -94 55 -44 -127 89 39 22 39 55 105 -94 -10 89 -44 105 5 -60 -110 122 105 105 -127 -77 -10 89 -77 55 -44 122 55 5 -27 -44 -27 5 55 -127 -27 89 -44 105 22 -44 -94 -110 -127 -110 -60 -10 72 -94 22 -110 55 -27 -94 -127 122 122 -127 -94 -27 
105 -60 -27 -44 -127 5 55 55 -10 122 -60 -44 -94 55 -110 -77 -110 55 -94 -60 -77 122 -27 39 39 -10 122 -60 -44 -94 72 -94 -60 -94 89 -77 -10 -27 -110 22 89 105 39 -77 5 22 -10 -110 -10 22 5 -77 39 89 72 5 -127 -44 -44 -94 55 -127 -94 -127 
89 -127 89 -44 22 5 -94 5 22 -44 72 122 89 -27 39 22 -60 39 72 5 -127 -77 -110 55 -127 -127 55 -94 -77 -127 22 72 55 -44 39 55 -10 105 -127 105 -27 39 39 -60 39 55 -10 122 -94 -127 22 105 89 5 122 -127 89 -44 5 -10 -110 -27 -27 -94 
72 -10 -127 -10 89 -110 -77 -77 -94 123 39 -77 55 -110 -44 -10 5 -10 -60 122 22 -110 -10 55 105 105 105 55 -10 -127 5 122 -77 -27 -10 -10 -60 -127 39 -77 22 105 -110 -77 -94 -127 72 -10 122 -27 55 105 -127 -127 105 39 -44 105 -44 39 105 -127 -127 105 
-27 -94 -60 55 -10 22 122 56 73 -75 123 123 -27 -110 -94 5 -77 -77 22 -60 -60 39 -60 -60 22 -60 -77 5 -77 -94 -10 -110 -127 -60 105 89 -110 39 22 89 -27 -44 5 -110 122 -77 72 22 89 -44 -77 -27 105 55 105 -27 -77 -27 89 39 72 -60 -127 -94 
-10 55 122 -77 -10 72 -109 -25 74 -107 -8 107 -59 55 -94 22 -127 5 -127 5 -110 22 -94 72 -44 122 22 -77 89 5 -77 105 39 -44 -110 105 39 -10 -60 -110 105 72 39 5 -10 -44 -60 -60 -77 -77 -77 -77 -77 -60 -44 -27 5 22 55 105 -127 -77 -27 22 
-10 -110 39 -94 39 -110 -9 74 -107 -40 8 41 73 89 89 72 55 22 -27 -93 105 22 -77 72 -44 89 -60 39 -127 -44 22 72 122 -110 -94 -94 -94 -110 122 72 22 -44 -127 39 -60 89 -44 72 -77 22 105 -94 -27 22 55 72 89 89 72 39 5 -44 -110 72 
105 -94 -10 122 22 -26 -58 -41 9 110 -40 125 57 40 39 89 -94 41 -76 124 90 106 -127 -44 72 -27 -110 122 122 -94 -27 89 -27 -94 122 122 -110 -27 72 -44 -127 105 89 122 -77 39 -94 89 39 39 55 122 -44 105 5 -44 -60 -27 22 122 -10 -94 105 89 
-77 -27 -94 5 -27 105 123 41 92 43 -124 -125 6 39 -44 40 -8 109 125 9 57 -25 73 39 -94 -94 89 -127 89 -94 -94 39 72 -10 55 5 122 122 5 39 -27 55 22 -127 -110 55 105 39 -127 122 -10 5 -77 -10 -60 39 39 -77 -44 -127 -44 -77 39 39 
-94 -94 -10 -127 89 105 -59 107 74 108 -42 -125 123 -94 40 -25 -24 44 -72 128 -106 -25 123 89 122 -27 -127 122 -94 39 -44 -44 22 -94 105 122 -60 89 55 89 -77 89 72 122 -27 -110 -110 -44 89 22 39 122 5 -44 -10 72 -10 -44 5 105 22 22 72 -60 
89 -110 5 -94 -127 -110 -44 90 -9 -42 -9 56 -77 105 73 92 -89 46 -37 -53 -39 42 -75 106 89 122 -60 72 5 -10 22 122 -10 -77 -94 -44 55 -60 -127 122 -94 5 -110 105 89 -127 -26 -127 89 89 -127 -27 -127 89 89 -110 -10 -110 105 122 -77 22 -60 -110 
5 89 22 39 -94 -127 -44 122 -127 -9 -44 5 -94 -93 24 -41 10 -87 -103 -3 -89 -41 90 72 -127 72 89 -44 -77 -10 -110 -94 22 -27 22 -77 -77 22 -44 5 -110 -127 -44 -110 -76 56 24 106 23 39 -110 122 -77 89 89 -60 -110 -60 89 89 -77 122 -110 39 
-77 -110 72 -60 22 72 55 22 -77 39 122 -110 -110 89 -9 107 -73 -54 -72 127 8 124 -76 -60 -94 105 -10 89 -127 -110 122 39 -94 5 39 39 5 -94 39 122 -94 -110 105 6 -125 -58 -24 -42 -108 56 -94 -27 -10 -27 -94 55 -110 -44 -44 -60 122 -10 89 -127 
55 55 -77 -60 89 105 5 39 -60 -27 -127 -77 105 -110 90 -125 74 -106 92 -90 124 -59 -94 -10 -44 72 39 -110 -127 -10 -10 105 105 -27 -10 -127 -110 39 55 -44 -10 -110 -60 123 -92 92 -123 75 -125 73 -110 105 -77 -127 -44 -77 22 -10 105 72 -77 -77 39 39 
55 122 55 105 5 22 -110 -110 5 -10 72 22 89 5 55 -59 -43 107 90 -58 -94 -10 -60 5 -77 -44 122 122 -10 -10 89 55 -127 72 -127 55 89 -27 -27 105 89 -60 -109 -25 -91 -40 -122 -106 58 57 -93 -110 -10 -60 22 -44 5 -94 -60 72 72 -60 -94 5 
-27 39 22 -110 -60 -110 22 55 -27 89 89 5 89 72 -44 22 -10 123 -110 105 -44 -27 -110 -10 -10 -110 -44 -60 89 -127 105 -44 -10 -77 39 39 -44 39 39 -77 -10 -44 105 -109 91 -41 -23 -91 7 6 -94 -10 -27 122 -94 -127 5 39 -27 89 105 22 105 105 
122 -127 -94 -44 22 122 -44 89 -10 -110 89 39 5 5 22 55 105 -77 5 122 5 -110 72 5 -44 -60 -60 -44 -10 55 122 -44 89 -44 122 39 -27 -60 -77 -77 -60 -9 39 123 -25 91 -24 -125 57 6 -27 -43 -44 -10 22 89 -76 22 -110 39 -60 -127 89 55 
-77 39 105 105 39 -94 -10 5 -44 105 -60 -27 -60 105 -44 5 -10 -77 39 105 105 55 -77 5 22 -10 -127 -27 5 -10 -110 5 55 55 -27 105 -94 -77 122 6 90 124 73 -26 73 123 91 6 123 -76 -92 107 -26 56 56 6 -108 -9 6 -27 -127 -10 22 5 
39 22 -77 22 22 -44 72 122 72 -44 22 22 -77 22 39 -10 105 -110 122 22 89 89 5 105 -127 89 -44 5 -10 -110 -27 -27 -94 22 55 5 -110 -44 -59 107 -58 -41 -108 7 56 22 -93 -27 -25 -107 -6 9 -41 92 -124 107 8 74 91 6 122 -127 105 -27 
89 -94 -60 -44 -44 -94 105 5 -127 -27 55 105 122 105 72 5 -94 55 -110 -27 22 55 39 5 -60 122 5 105 -60 -10 22 22 -10 -77 105 -10 105 -77 -9 24 25 9 -57 124 6 -127 -44 23 75 76 61 11 -72 76 -57 42 109 -124 -108 -126 89 5 -94 39 
22 22 105 5 5 72 -27 -27 39 -60 -77 -10 -110 122 -77 89 55 122 5 -27 22 -94 -127 -77 72 39 89 -44 -94 -44 89 39 89 -44 -94 -60 55 6 41 -107 109 -122 -6 -74 -58 56 -10 7 126 61 80 -86 96 111 -55 127 -122 -40 -124 -108 -26 -110 -110 -27 
5 -94 72 -27 -110 55 -27 -94 89 22 -44 -110 105 39 5 -44 -94 -127 105 72 55 39 22 5 -10 -10 -10 5 5 22 39 55 89 105 -127 -77 -44 5 56 107 -91 -23 42 107 -93 -10 73 -108 -6 95 -69 30 -121 -22 93 -41 76 -57 74 -59 89 -44 122 5 
-44 89 -60 39 -127 -60 5 55 105 -127 -110 -110 -127 122 89 39 -27 -94 89 -10 -110 22 -110 5 122 -44 39 105 -110 -60 -27 -10 -10 -10 -27 -60 -94 105 40 -25 -125 42 -75 57 -93 22 122 -59 8 77 128 -104 -73 -73 -74 -75 -107 124 74 6 -77 105 5 -110 
122 22 -44 -60 -60 -10 72 -60 89 22 5 5 55 -127 -10 -127 72 39 39 72 -110 5 -110 89 39 39 89 -110 5 -110 72 22 22 55 122 -44 105 22 -27 -26 -9 57 -109 40 -44 -94 -110 -93 -25 75 -56 109 58 41 56 123 -58 73 -26 -77 -94 -94 -27 55 
89 72 -60 -27 -110 -44 -77 22 22 -94 -44 -110 -27 -60 55 72 -27 22 -44 55 39 -94 -60 105 -94 -127 -27 -27 122 -110 72 -110 122 -27 -10 -127 -77 122 -44 -60 72 90 -10 55 5 105 89 -27 6 -76 7 -42 73 89 -27 22 -43 39 5 -127 -110 55 122 55 
-60 -127 122 -77 55 5 5 89 -10 -60 -27 72 -27 -60 -10 105 22 5 72 -60 -127 -127 -44 105 55 89 -94 72 39 89 -77 105 89 -110 5 -60 -44 22 -94 122 -127 -44 122 89 122 -44 -127 122 -94 22 -43 -44 22 -94 105 122 -60 105 55 89 -77 105 72 122 
55 105 -60 105 39 39 89 -77 89 22 22 89 -77 89 39 39 105 -44 122 72 72 -127 -10 -110 122 -127 -60 55 -44 -77 -60 5 -127 55 22 39 122 -27 -110 -127 -110 -27 105 22 5 22 105 -10 -94 -110 -77 5 -110 89 72 105 -77 72 5 -10 39 -127 22 -44 
72 -44 -60 22 -44 -27 105 89 -110 72 89 -60 -110 -44 122 122 -27 -94 -44 105 105 -60 -127 -94 39 22 105 22 39 -94 -127 -60 122 122 -27 -60 -10 -110 -110 -10 -77 -27 122 105 -60 122 -110 39 5 89 5 22 -127 105 -94 72 89 -77 -127 -77 89 89 -77 122 
-27 22 22 -27 -110 22 105 -127 -127 89 -10 105 -77 -44 -60 -110 39 -110 -44 -10 -44 -110 39 -110 -60 -44 -77 122 5 89 -110 -110 122 39 -94 -10 39 39 -10 -110 22 105 -127 122 72 -27 89 -110 -77 -94 105 -10 105 -94 -77 -94 89 -27 72 -127 -127 105 22 -94 
-44 -44 105 122 5 22 -94 -60 105 -110 55 105 22 72 5 72 5 72 22 89 39 -127 89 -77 -110 -10 -27 89 72 -77 -77 39 55 -77 -77 72 89 -10 5 -94 -60 105 -110 72 122 39 105 22 89 39 105 55 -127 89 -77 -110 -10 -44 72 39 -110 -110 5 5 
-44 22 -44 -10 -110 -94 55 39 -110 122 -44 -110 -44 -127 -94 72 89 -44 -60 55 22 105 39 105 22 55 -60 -44 89 72 -94 -127 -60 -127 -60 105 -127 22 39 -110 -127 -27 -60 5 -60 -10 -110 -77 72 72 -77 -94 5 -44 22 -44 5 -94 -77 72 72 -77 -110 -10 
55 -127 122 5 72 22 -110 -60 -127 -10 5 -77 5 5 -94 -27 -44 89 -127 105 -44 -10 -77 22 22 -60 22 5 -94 -27 -60 72 105 55 -94 -77 122 -60 -60 105 -77 -94 55 105 55 -77 -44 -110 5 5 -77 22 5 -94 -27 -60 72 122 72 -77 -44 -127 -27 -10 
-77 -94 -94 -60 -27 39 122 -27 89 -27 -127 72 5 -27 -44 -44 -10 39 105 -77 39 -94 55 -44 -110 105 72 55 72 105 -110 -44 55 -94 39 -77 105 22 -10 -44 -44 -44 -10 55 122 -44 72 -44 105 22 -44 -77 -110 -110 -94 -44 5 89 -77 39 -77 89 5 -60 
89 39 -94 -10 22 -27 -127 -27 5 -27 -110 5 55 39 -27 105 -94 -77 122 5 105 122 89 -10 89 122 105 22 -127 -60 -77 122 -10 72 89 22 -77 5 39 5 -94 5 55 39 -44 89 -127 -127 72 -44 39 55 5 -110 -10 22 -10 -110 5 55 39 -27 89 -110 
22 22 -60 39 55 5 -127 -77 -110 55 -127 -127 72 -94 -60 -110 39 105 72 -10 72 89 22 -127 -94 -127 22 89 72 -10 89 105 55 -94 -44 -77 89 -110 -110 89 -77 -44 -94 39 89 72 -27 55 55 -10 105 -127 105 -27 39 22 -60 22 39 -10 105 -110 122 5 
39 72 72 39 -10 -94 55 -77 22 89 122 122 105 55 -27 -127 -10 89 -94 -60 -44 -60 -110 72 -27 105 -60 22 72 89 72 22 -44 122 -10 105 -77 -44 -10 -27 -60 -127 39 -77 22 105 -94 -77 -77 -110 89 -10 -127 -10 72 -127 -94 -94 -127 72 -10 -127 -10 89 
72 -77 122 -127 -10 -77 -44 55 -10 5 105 39 55 -110 72 89 -94 89 105 -77 105 105 -60 105 105 -77 89 89 -94 72 55 -127 22 5 89 -27 -44 22 -94 -110 -44 105 72 -127 22 -10 39 -94 -127 -77 72 22 72 -60 -110 -60 72 22 55 -77 122 -110 22 -44 
55 122 -77 -10 72 -110 -27 55 -110 -27 72 -77 22 -127 -10 122 -27 105 -27 105 -10 -127 22 -94 72 -27 -127 39 -44 -127 55 -27 -94 89 22 -27 -94 122 72 39 -10 -44 -77 -110 -127 122 105 89 89 89 89 89 105 122 -127 -110 -77 -60 -27 22 55 105 -110 -44 
105 -10 -127 5 122 -27 72 -110 -44 5 55 89 105 122 122 105 72 22 -27 -94 89 5 -94 55 -77 39 -110 -10 72 -110 -44 5 39 55 72 72 55 39 5 -44 -110 72 -10 -110 39 -77 55 -94 5 89 -94 -27 22 72 105 122 122 105 89 55 5 -44 -110 72 
-94 -27 89 -27 -110 122 105 -127 -44 55 -60 122 72 72 89 -110 5 -127 55 5 -10 22 72 -94 55 -44 -94 -110 -94 -27 55 -77 105 39 22 39 89 -77 39 -60 -110 122 -127 -77 5 -127 22 -44 -60 -60 -10 72 -77 89 5 -27 -10 22 105 -44 105 39 -10 -10 
