-108 -118 -128 -114 -98 -120 -110 -110 -105 -114 -114 -101 -105 -98 -110 -105 -101 -102 -98 -105 -110 -125 -103 -124 -110 -110 -102 -105 -103 -114 -118 -105 
-118 -120 -105 -120 -115 -111 -118 -128 -114 -102 -102 -101 -108 -115 -110 -101 -102 -102 -115 -100 -122 -114 -120 -123 -110 -97 -124 -120 -102 -105 -98 -114 
-101 -102 -128 -122 -114 -110 -98 -120 -103 -128 -105 -122 -102 -114 -118 -102 -102 -110 -110 -114 -110 -110 -103 -103 -123 -116 -104 -100 -114 -103 -114 -102 
-115 -110 -101 -102 -101 -108 -114 -105 -122 -120 -114 -128 -101 -114 -102 -97 -118 -123 -97 -103 -119 -114 -103 -109 -105 -119 -100 -120 -108 -108 -105 -114 
-122 -118 -128 -122 -102 -103 -114 -115 -102 -108 -122 -103 -120 -103 -125 -106 -102 -113 -106 -94 -94 -90 -94 -119 -89 -118 -101 -102 -108 -111 -122 -101 
-103 -103 -110 -103 -103 -118 -108 -115 -101 -102 -103 -101 -128 -110 -100 -103 -113 -102 -103 -92 -92 -109 -91 -106 -79 -89 -91 -120 -115 -102 -115 -128 
-114 -103 -114 -98 -101 -103 -102 -101 -115 -110 -122 -108 -114 -122 -119 -120 -106 -94 -102 -84 -94 -80 -75 -84 -68 -79 -96 -100 -119 -103 -108 -115 
-101 -114 -102 -105 -114 -108 -105 -122 -110 -115 -126 -122 -120 -108 -100 -101 -102 -92 -84 -68 -87 -65 -68 -65 -61 -65 -94 -89 -114 -114 -115 -108 
-120 -98 -120 -128 -118 -120 -114 -114 -108 -108 -101 -98 -115 -114 -103 -101 -112 -97 -82 -92 -75 -64 -72 -59 -60 -63 -85 -88 -112 -107 -115 -103 
-128 -118 -108 -105 -98 -101 -128 -101 -101 -105 -107 -120 -98 -110 -120 -110 -116 -101 -87 -78 -90 -82 -70 -65 -53 -75 -86 -83 -99 -114 -122 -110 
-108 -105 -120 -108 -111 -118 -110 -108 -120 -107 -110 -114 -108 -102 -114 -98 -101 -96 -113 -100 -108 -85 -75 -75 -51 -84 -69 -94 -104 -105 -122 -111 
-122 -102 -114 -119 -108 -115 -103 -114 -103 -114 -104 -120 -114 -101 -122 -110 -104 -123 -118 -102 -102 -93 -79 -75 -60 -71 -72 -86 -101 -102 -109 -109 
-122 -107 -100 -106 -121 -100 -110 -110 -114 -110 -110 -103 -98 -114 -103 -114 -102 -103 -113 -112 -114 -110 -102 -88 -68 -89 -82 -75 -94 -95 -98 -100 
-102 -108 -100 -117 -95 -100 -121 -114 -118 -122 -114 -103 -108 -114 -103 -120 -98 -101 -114 -102 -101 -102 -86 -92 -52 -54 -71 -52 -64 -57 -76 -97 
-107 -112 -102 -97 -92 -112 -109 -104 -114 -128 -120 -115 -101 -110 -105 -103 -114 -96 -93 -118 -101 -110 -99 -87 -58 -67 -51 -21 -42 -18 -60 -70 
-102 -94 -89 -90 -74 -100 -102 -113 -103 -115 -114 -111 -122 -102 -124 -115 -123 -101 -115 -103 -102 -94 -96 -58 -47 -34 -24 -14 -12 5 -36 -66 
-117 -89 -79 -78 -87 -90 -75 -99 -112 -121 -115 -114 -102 -117 -97 -107 -103 -105 -94 -118 -94 -92 -81 -64 -47 -24 1 9 9 37 -2 -24 
-112 -105 -76 -89 -55 -60 -69 -99 -104 -94 -93 -103 -98 -107 -123 -101 -110 -110 -115 -114 -101 -80 -65 -35 -26 -22 8 6 34 65 -9 -25 
-95 -85 -85 -57 -65 -64 -75 -62 -88 -87 -90 -93 -111 -96 -120 -115 -97 -101 -115 -103 -91 -76 -64 -28 -33 -12 15 65 55 96 24 1 
-102 -92 -97 -75 -45 -50 -57 -56 -67 -78 -79 -89 -89 -91 -104 -101 -109 -120 -123 -89 -76 -58 -57 -23 0 -6 53 78 72 128 14 8 
-110 -101 -91 -61 -28 -18 -17 -25 -38 -68 -66 -77 -91 -89 -110 -120 -101 -123 -116 -100 -97 -80 -60 -22 -14 -2 32 66 87 108 40 -15 
-102 -110 -95 -53 -9 8 2 12 0 -32 -61 -66 -94 -102 -103 -114 -115 -100 -104 -119 -93 -76 -73 -21 -8 25 60 96 98 124 57 0 
-100 -109 -84 -47 -7 10 36 9 0 -38 -62 -77 -77 -93 -114 -103 -102 -122 -97 -97 -103 -99 -85 -72 -60 -28 -3 12 36 46 -5 -32 
-104 -87 -76 -41 -5 43 56 25 5 -13 -51 -66 -101 -110 -110 -114 -115 -123 -100 -110 -118 -107 -115 -83 -67 -60 -16 -6 -5 -3 -29 -48 
-114 -112 -79 -62 -29 -1 13 -9 -20 -44 -71 -70 -78 -85 -102 -111 -106 -102 -104 -114 -102 -121 -95 -95 -95 -84 -69 -51 -44 -44 -79 -80 
-95 -92 -91 -54 -39 -27 -19 -26 -39 -51 -67 -81 -86 -113 -99 -110 -110 -110 -97 -114 -115 -119 -111 -104 -114 -100 -87 -97 -114 -76 -113 -95 
-101 -102 -115 -80 -64 -60 -54 -54 -61 -67 -75 -80 -99 -110 -102 -115 -107 -122 -114 -103 -102 -122 -93 -119 -97 -100 -107 -115 -102 -109 -103 -118 
-102 -101 -102 -92 -111 -79 -85 -87 -76 -83 -93 -95 -100 -95 -114 -115 -119 -108 -98 -102 -105 -97 -115 -95 -101 -98 -118 -102 -112 -108 -107 -122 
-114 -102 -117 -113 -109 -92 -98 -115 -94 -91 -89 -102 -86 -105 -102 -103 -102 -110 -118 -110 -98 -100 -97 -103 -110 -103 -119 -119 -118 -101 -108 -101 
-111 -103 -103 -97 -95 -116 -115 -106 -101 -93 -91 -111 -115 -110 -111 -103 -103 -122 -122 -114 -110 -102 -100 -117 -115 -107 -103 -124 -119 -109 -107 -97 
-111 -101 -122 -110 -105 -128 -118 -107 -102 -94 -116 -110 -109 -102 -102 -122 -122 -114 -114 -110 -110 -103 -105 -102 -102 -101 -102 -98 -102 -97 -103 -101 
-101 -120 -120 -114 -111 -102 -98 -114 -105 -122 -113 -97 -115 -100 -114 -128 -110 -114 -101 -103 -114 -115 -98 -98 -103 -103 -105 -103 -105 -102 -102 -122 
