32 32

00000000000000000000000000000000
01111111111111111111111111111110
01111111111111101111111111111110
01111111110111101111011111110110
01110111111111111111111111100110
01110011111112111111111111001110
01111001111111111111111110011110
01111100111111000001111110111110
01111111111110011100100111111110
01111111111100111111100111111110
01111111001101111111111111211110
01110111001111110111111111011110
01111111111111111111100111111110
01111111111111111111110011111110
01112111110111100110111011100110
01111111101111100111110011111110
01001111001101100111100111111110
01111111001111111111001111111110
01111111100111111111111111011110
01111111110111110111111111111110
01101111111111111121100111111110
01111111111110111111100111211210
01112111100110011100111110011110
01111111100111100001111111001110
01111110111111111111111111100110
01111000111111111111111111110110
01110011111110111011011111110110
01110111111111111011111111111110
01111111121111111111111111211110
01111111111111111111111111111110
01111111111111111111111111111110
00000000000000000000000000000000


00000000000000000000000000000000
01111111111111111111111111111110
01111111111111101111111111111110
01111111110111101111011111110110
01110111111111111111111111100110
01110011111111111111111111001110
01111001111111111111111110011110
01111100111111000001111110111110
01111111111110011100100111111110
01111111111100111111100111111110
01111111001101111111111111111110
01110111001111110111111111011110
01111111111111111111100111111110
01111111111111111111110011111110
01111111110111100110111011100110
01111111101111100111110011111110
01001111001101100111100111111110
01111111001111111111001111111110
01111111100111111111111111011110
01111111110111110111111111111110
01101111111111111111100111111110
01111111111110111111100111111110
01111111100110011100111110011110
01111111100111100001111111001110
01111110111111111111111111100110
01111000111111111111111111110110
01110011111110111011011111110110
01110111111111111011111111111110
01111111111111111111111111111110
01111111111111111111111111111110
01111111111111111111111111111110
00000000000000000000000000000000