16 16

0000000000000000
0111111111111110
0121111111111210
0111111001111110
0111111001111110
0111111001111110
0111111111111110
0110001111000110
0110001111000110
0111111111111110
0111111001111110
0111111001111110
0111111001111110
0121111111111210
0111111111111110
0000000000000000

0000000000000000
0111111111111110
0111111111111110
0111111001111110
0111111001111110
0111111001111110
0111111111111110
0110001111000110
0110001111000110
0111111111111110
0111111001111110
0111111001111110
0111111001111110
0111111111111110
0111111111111110
0000000000000000