-119 -119 -117 -118 -114 -113 -106 -106 -103 -102 -103 -104 -107 -102 -116 -118 
-119 -117 -116 -116 -113 -108 -97 -94 -91 -98 -95 -92 -96 -90 -104 -110 
-117 -116 -113 -103 -92 -89 -74 -75 -74 -82 -78 -76 -82 -81 -97 -99 
-118 -109 -98 -84 -66 -64 -47 -64 -66 -75 -76 -71 -72 -72 -89 -98 
-108 -95 -74 -55 -25 -19 0 -19 -27 -39 -52 -52 -59 -57 -79 -95 
-106 -88 -61 -28 2 9 31 11 3 -14 -37 -41 -56 -59 -85 -98 
-89 -64 -34 1 34 59 105 78 53 15 -7 -24 -50 -38 -82 -94 
-98 -77 -44 0 48 75 126 98 78 36 0 -7 -35 -13 -77 -86 
-97 -74 -51 -6 35 63 128 108 95 44 0 1 -12 7 -42 -54 
-98 -87 -65 -19 14 48 108 85 65 26 7 14 6 23 -17 -37 
-103 -95 -74 -51 -20 -3 50 38 20 0 -4 4 17 47 8 -20 
-107 -103 -94 -77 -46 -29 -3 -17 -20 -21 -21 -6 13 45 5 -21 
-113 -107 -103 -89 -71 -63 -34 -46 -49 -71 -64 -33 -21 5 -24 -47 
-118 -113 -109 -107 -94 -92 -72 -82 -84 -102 -88 -59 -60 -25 -63 -66 
-122 -118 -116 -114 -111 -108 -94 -105 -104 -108 -111 -97 -98 -66 -103 -104 
-122 -122 -119 -119 -116 -115 -111 -112 -112 -113 -116 -119 -122 -104 -126 -127 
