-112 -112 -105 -111 -106 -112 -104 -112 -105 -106 -105 -95 -100 -89 -109 -111 
-112 -105 -100 -103 -98 -102 -85 -83 -80 -100 -94 -82 -84 -75 -94 -99 
-105 -100 -93 -88 -72 -71 -45 -39 -33 -65 -71 -62 -61 -55 -75 -86 
-112 -105 -96 -84 -67 -60 -40 -46 -43 -53 -58 -48 -47 -44 -68 -83 
-111 -110 -92 -75 -51 -40 -15 -20 -23 -17 -32 -27 -35 -33 -64 -81 
-115 -113 -94 -78 -49 -35 8 5 2 5 -14 -10 -33 -45 -72 -88 
-119 -114 -97 -80 -41 -19 63 52 63 54 16 4 -28 -44 -77 -95 
-119 -114 -105 -76 -19 11 93 74 95 72 24 -1 -40 -60 -102 -110 
-118 -112 -99 -60 -10 26 113 104 115 80 13 -16 -53 -76 -108 -114 
-114 -112 -88 -46 4 51 128 115 103 73 12 -22 -64 -97 -115 -118 
-113 -109 -81 -49 -4 32 88 83 57 28 -32 -68 -96 -109 -115 -117 
-112 -105 -92 -62 -20 10 47 27 7 -11 -69 -86 -105 -108 -114 -117 
-114 -111 -100 -80 -50 -41 -6 -32 -39 -66 -104 -111 -116 -113 -117 -120 
-116 -112 -105 -98 -80 -80 -58 -82 -85 -110 -118 -115 -118 -117 -120 -120 
-120 -117 -112 -112 -109 -108 -94 -112 -113 -119 -120 -119 -121 -119 -124 -125 
-120 -120 -117 -118 -118 -119 -117 -120 -120 -120 -120 -122 -125 -124 -128 -128 
