11 -74 -69 72 -110 76 -22 63 109 -91 -78 -45 3 91 -6 -36 
-74 -25 -78 -50 40 113 -68 -100 -37 93 6 126 -55 118 -114 -76 
90 52 88 63 -92 -31 -69 114 1 -71 27 -25 128 -92 -77 89 
-59 63 13 75 108 -61 103 -11 118 121 48 -19 -9 -85 44 20 
-101 -11 -57 -14 -94 -32 -73 42 100 102 87 46 2 -27 -42 -23 
59 60 58 -31 16 -103 65 -22 76 82 -50 118 39 -73 -44 109 
-26 91 59 -34 -12 -14 120 29 101 -14 55 -22 90 93 96 -10 
88 21 -14 55 84 -109 38 -109 -20 -79 20 111 34 99 -100 -2 
-81 -47 119 -59 -74 53 -105 -81 -68 -85 -87 -85 -41 48 -45 -62 
-118 92 -61 83 22 -51 34 34 105 -27 87 -89 -120 -43 82 -18 
11 70 31 14 -83 -114 14 14 -16 66 -80 -66 -19 -45 9 21 
-108 51 70 23 -30 -18 -90 55 9 -122 -65 51 37 -16 -46 22 
-113 -40 6 46 77 -95 7 -79 -109 -68 76 92 -9 37 -7 -124 
31 -25 -13 31 60 31 -97 91 90 90 47 -82 -110 -80 -36 -21 
1 -25 -54 75 1 -113 60 -25 1 17 -70 -128 -23 -96 18 -11 
31 75 90 -99 46 -99 1 -40 90 -25 -54 60 -70 91 -69 -40 
