-20 -20 -20 -20 -20 -20 -20 -20 -20 -20 -20 -20 -20 -20 -20 -20 -19 -19 -19 -19 -19 -19 -19 -19 -19 -19 -19 -19 -19 -19 -19 -19 -19 -19 -19 -19 -19 -19 -19 -19 -19 -19 -19 -19 -19 -19 -19 -19 -19 -19 -19 -19 -19 -3 -19 -19 -19 -19 -19 -19 -19 -19 -19 -19 
-20 -20 -20 -20 -20 -20 -20 -20 -20 -20 -24 -20 -20 -20 -20 -20 -19 -19 -19 -19 -19 -19 -19 -19 -19 -19 -19 -19 -19 -19 -19 -19 -19 -19 -19 -19 -19 -19 -19 -19 -19 -19 -19 -19 -19 -19 -19 -19 -19 -3 -3 -3 -3 7 -3 -3 -3 -3 -19 -19 -19 -19 -19 -19 
-20 -20 -20 -20 -20 -20 -24 -24 -24 -24 -30 -25 -24 -24 -24 -20 -19 -19 -19 -19 -19 -19 -19 -19 -19 -19 -19 -19 -19 -19 -19 -19 -19 -19 -19 -19 -19 -19 -19 -19 -19 -19 -19 -19 -19 -19 -19 -19 -3 -3 7 7 7 19 7 7 7 -3 -3 -19 -19 -19 -19 -19 
-20 -20 -20 -20 -20 -24 -24 -30 -30 -30 -34 -30 -30 -30 -25 -25 -19 -19 -19 -19 -19 -19 -19 -19 -19 -19 -18 -19 -19 -19 -19 -19 -19 -19 -19 -19 -19 -19 -19 -19 -19 -19 -19 -19 -19 -19 -19 -3 7 7 19 19 19 26 19 19 19 7 7 -3 -19 -19 -19 -19 
-20 -20 -20 -20 -24 -30 -30 -34 -34 -34 -38 -35 -34 -34 -30 -30 -29 -19 -19 -19 -19 -19 -18 -17 -17 -17 -17 -18 -18 -18 -19 -19 -19 -19 -19 -19 -19 -19 -19 -19 -19 -19 -19 -19 -19 -19 -3 7 7 19 26 26 26 43 26 26 26 19 7 7 -3 -19 -19 -19 
-20 -20 -20 -24 -30 -30 -34 -38 -39 -39 -42 -39 -39 -39 -35 -30 -34 -29 -19 -19 -18 -17 -17 -17 -17 -17 -17 -17 -17 -17 -18 -19 -19 -19 -19 -19 -19 -19 -19 -19 -19 -19 -19 -19 -19 -3 -3 7 19 26 43 43 43 59 43 43 43 26 19 7 -3 -3 -19 -19 
-20 -20 -24 -24 -30 -34 -38 -42 -43 -43 -48 -44 -43 -43 -39 -35 -35 -30 -26 -17 -17 -17 -16 -16 -14 -16 -14 -17 -17 -17 -17 -18 -19 -19 -19 -19 -19 -19 -19 -19 -19 -19 -19 -19 -19 -3 7 19 26 43 43 59 59 75 59 59 43 43 26 19 7 -3 -19 -19 
-20 -20 -24 -30 -34 -38 -42 -43 -48 -48 -52 -48 -48 -44 -44 -39 -44 -34 -25 -19 -17 -17 -16 -14 -14 -14 -14 -14 -16 -17 -17 -17 -19 -19 -19 -19 -19 -19 -19 -19 -19 -19 -19 -19 -19 -3 7 19 26 43 59 75 75 90 75 75 59 43 26 19 7 -3 -19 -19 
-20 -20 -24 -30 -34 -39 -43 -48 -52 -53 -57 -54 -53 -48 -44 -39 -48 -34 -27 -18 -17 -17 -14 -14 -14 -14 -13 -14 -14 -16 -17 -17 -17 -19 -19 -19 -19 -19 -19 -19 -19 -19 -19 -19 -19 -3 7 19 26 43 59 75 90 104 90 75 59 43 26 19 7 -3 -19 -19 
-20 -20 -24 -30 -34 -39 -43 -48 -53 -58 -62 -59 -54 -49 -45 -39 -52 -35 -30 -18 -17 -16 -14 -14 -11 -11 -11 -13 -14 -14 -17 -17 -17 -18 -19 -19 -19 -19 -19 -19 -19 -19 -19 -19 -3 7 19 26 43 59 75 90 104 127 104 90 75 59 43 26 19 7 -3 -19 
-20 -24 -30 -34 -38 -42 -48 -52 -57 -62 -67 -63 -59 -54 -48 -44 -49 -38 -32 -23 -17 -17 -14 -13 -11 -11 -11 -13 -14 -14 -17 -17 -17 -18 -19 -19 -19 -19 -19 -19 -19 -19 -19 -19 -19 -3 7 19 26 43 59 75 90 104 90 75 59 43 26 19 7 -3 -19 -19 
-20 -20 -25 -30 -35 -39 -44 -48 -54 -59 -63 -59 -55 -49 -46 -40 -48 -35 -29 -21 -18 -17 -15 -14 -11 -11 -11 -14 -14 -14 -16 -17 -17 -17 -18 -19 -19 -19 -19 -19 -19 -19 -19 -19 -19 -3 7 19 26 43 59 75 75 90 75 75 59 43 26 19 7 -3 -19 -19 
-20 -20 -24 -30 -34 -39 -43 -48 -53 -54 -59 -55 -55 -49 -46 -39 -48 -35 -29 -21 -17 -17 -16 -15 -14 -13 -14 -14 -14 -16 -17 -17 -17 -18 -19 -19 -19 -19 -19 -19 -19 -19 -19 -19 -19 -3 7 19 26 43 43 59 59 76 59 59 43 43 27 19 8 -2 -19 -19 
-20 -20 -24 -30 -34 -39 -43 -44 -48 -49 -54 -49 -49 -46 -46 -40 -39 -35 -30 -22 -19 -19 -18 -16 -16 -15 -14 -16 -16 -16 -17 -17 -17 -18 -19 -19 -19 -19 -19 -19 -19 -19 -19 -19 -19 -3 -3 7 19 26 43 43 43 59 43 43 43 27 19 9 -2 -2 -19 -19 
-20 -20 -24 -25 -30 -35 -39 -44 -44 -45 -48 -46 -46 -46 -40 -37 -36 -32 -32 -24 -21 -21 -19 -19 -17 -17 -17 -17 -17 -17 -17 -17 -17 -18 -19 -19 -19 -19 -19 -19 -19 -19 -19 -19 -19 -19 -3 7 8 19 27 27 28 43 28 28 28 19 9 9 -2 -19 -19 -19 
-20 -20 -20 -25 -30 -30 -35 -39 -39 -39 -44 -40 -39 -40 -37 -34 -36 -32 -24 -29 -25 -24 -25 -23 -26 -20 -19 -19 -17 -17 -17 -17 -18 -18 -18 -19 -18 -18 -17 -18 -18 -19 -19 -19 -19 -19 -19 -2 8 9 19 19 19 30 19 19 19 11 9 -1 -18 -19 -19 -19 
-18 -18 -18 -17 -29 -33 -34 -39 -45 -48 -48 -47 -48 -39 -36 -36 -32 -29 -29 -29 -29 -29 -28 -29 -29 -28 -26 -25 -24 -17 -18 -18 -18 -19 -19 -18 -17 -17 -17 -17 -17 -17 -18 -19 -19 -19 -19 -19 -2 -1 9 11 11 19 11 11 11 0 0 -18 -18 -18 -19 -19 
-18 -18 -17 -17 -17 -27 -29 -32 -33 -34 -37 -35 -35 -35 -32 -32 -29 -30 -30 -31 -32 -35 -34 -34 -34 -32 -29 -28 -26 -25 -19 -18 -19 -19 -18 -17 -17 -17 -17 -17 -17 -17 -17 -18 -19 -19 -19 -19 -19 -1 0 0 0 11 0 0 0 0 -17 -17 -18 -18 -18 -19 
-18 -18 -17 -17 -17 -14 -19 -19 -21 -28 -26 -25 -25 -29 -30 -24 -29 -30 -31 -37 -38 -39 -39 -39 -39 -38 -35 -33 -28 -27 -25 -19 -19 -18 -17 -17 -17 -17 -17 -17 -17 -17 -17 -17 -18 -19 -18 -19 -18 -18 -17 -17 -17 0 -17 -16 -17 -17 -17 -17 -17 -18 -18 -19 
-18 -18 -17 -17 -17 -14 -14 -15 -15 -15 -21 -19 -19 -21 -23 -28 -29 -31 -37 -39 -43 -45 -48 -48 -48 -45 -43 -39 -34 -28 -26 -23 -19 -17 -17 -17 -17 -17 -17 -17 -17 -17 -17 -17 -17 -18 -18 -18 -18 -18 -17 -17 -16 -16 -14 -14 -14 -14 -17 -17 -17 -18 -18 -19 
-19 -18 -18 -17 -17 -14 -14 -14 -13 -13 -13 -16 -16 -17 -21 -24 -29 -32 -38 -42 -47 -52 -53 -52 -53 -49 -46 -44 -39 -32 -27 -23 -21 -17 -17 -17 -16 -16 -16 -17 -16 -17 -17 -17 -17 -17 -17 -18 -18 -17 -17 -16 -14 -14 -14 -13 -14 -14 -14 -17 -17 -17 -18 -18 
-19 -18 -18 -18 -17 -14 -14 -13 -11 -11 -13 -15 -16 -17 -19 -24 -29 -35 -39 -45 -51 -56 -62 -63 -62 -62 -54 -48 -43 -39 -33 -27 -21 -19 -16 -16 -14 -16 -14 -14 -14 -17 -17 -17 -17 -17 -17 -18 -18 -17 -17 -14 -13 -14 -14 -13 -14 -14 -14 -17 -17 -17 -18 -19 
-19 -18 -18 -18 -17 -14 -13 -11 -11 -11 -11 -14 -16 -17 -20 -24 -28 -34 -39 -48 -53 -62 -66 -67 -67 -63 -64 -58 -49 -44 -39 -33 -26 -23 -21 -14 -14 -14 -14 -14 -11 -14 -17 -17 -17 -17 -17 -17 -17 -17 -16 -14 -11 -11 -11 -11 -13 -13 -14 -16 -17 -17 -18 -18 
-19 -19 -19 -18 -18 -17 -14 -13 -11 -11 -13 -15 -15 -16 -20 -24 -29 -35 -39 -48 -52 -63 -67 -76 -78 -75 -65 -69 -57 -51 -50 -39 -34 -29 -22 -19 -14 -13 -11 -11 -11 -13 -16 -17 -17 -17 -17 -17 -17 -17 -16 -14 -13 -11 -13 -11 -14 -14 -16 -17 -17 -17 -18 -18 
-19 -19 -19 -18 -18 -17 -14 -14 -14 -14 -13 -14 -15 -17 -18 -26 -29 -35 -39 -48 -52 -62 -69 -78 -87 -86 -78 -72 -69 -62 -57 -49 -42 -42 -32 -27 -21 -14 -14 -14 -11 -14 -17 -17 -17 -17 -17 -17 -17 -17 -17 -14 -14 -13 -11 -13 -14 -14 -16 -17 -17 -17 -18 -19 
-19 -19 -19 -18 -18 -18 -17 -16 -14 -14 -14 -14 -14 -17 -19 -22 -28 -33 -39 -44 -49 -62 -63 -75 -88 -87 -82 -79 -77 -75 -71 -59 -54 -53 -44 -36 -31 -26 -11 -11 -11 -17 -17 -17 -17 -17 -17 -17 -17 -17 -17 -16 -14 -14 -14 -14 -14 -14 -17 -17 -17 -18 -18 -19 
-19 -19 -19 -19 -18 -18 -18 -17 -17 -17 -16 -17 -17 -17 -19 -22 -26 -31 -35 -41 -47 -55 -64 -65 -78 -82 -83 -86 -91 -81 -83 -74 -66 -62 -56 -49 -38 -31 -22 -10 -11 -14 -17 -17 -17 -18 -17 -17 -17 -17 -17 -17 -14 -16 -14 -14 -16 -16 -17 -17 -17 -18 -18 -19 
-19 -19 -19 -19 -19 -18 -18 -18 -17 -17 -17 -17 -17 -17 -18 -23 -25 -28 -33 -39 -45 -48 -61 -69 -72 -79 -86 -91 -101 -98 -94 -87 -78 -71 -66 -60 -55 -38 -26 -18 -11 -11 -14 -17 -17 -18 -18 -19 -18 -17 -17 -17 -17 -17 -17 -17 -17 -17 -17 -17 -18 -18 -19 -19 
-19 -19 -19 -19 -19 -19 -19 -19 -18 -19 -17 -18 -18 -18 -19 -19 -24 -26 -28 -34 -39 -45 -49 -61 -73 -80 -91 -101 -103 -108 -106 -98 -97 -89 -75 -69 -63 -50 -33 -27 -21 -10 -11 -14 -18 -19 -19 -19 -18 -18 -17 -17 -17 -17 -17 -17 -17 -17 -17 -18 -18 -18 -19 -19 
-19 -19 -19 -19 -19 -19 -19 -19 -19 -19 -19 -19 -19 -19 -19 -19 -19 -25 -27 -28 -34 -39 -46 -53 -63 -77 -84 -100 -109 -114 -118 -114 -102 -101 -89 -76 -74 -59 -40 -31 -19 -18 -9 -11 -17 -19 -19 -19 -19 -18 -18 -17 -17 -17 -17 -17 -17 -17 -18 -18 -18 -19 -19 -19 
-19 -19 -19 -19 -19 -19 -19 -19 -19 -19 -19 -19 -19 -19 -19 -19 -19 -19 -25 -27 -28 -35 -44 -50 -59 -72 -86 -98 -109 -118 -121 -124 -117 -111 -98 -85 -77 -69 -44 -41 -24 -18 -15 -10 -14 -18 -19 -19 -19 -19 -18 -18 -17 -18 -18 -17 -18 -18 -18 -18 -19 -19 -19 -19 
-19 -19 -19 -19 -19 -19 -19 -19 -19 -19 -19 -19 -19 -19 -19 -19 -19 -19 -19 -24 -25 -27 -34 -39 -53 -64 -78 -93 -99 -115 -125 -127 -121 -118 -98 -86 -76 -65 -40 -36 -25 -13 -13 -13 -11 -17 -18 -19 -19 -19 -19 -19 -18 -18 -18 -18 -18 -18 -18 -19 -19 -19 -19 -19 
-19 -19 -19 -19 -19 -19 -19 -19 -19 -19 -19 -18 -19 -19 -19 -19 -19 -19 -19 -18 -23 -23 -28 -37 -45 -59 -73 -86 -100 -105 -119 -125 -128 -123 -104 -84 -73 -60 -38 -35 -25 -14 -9 -10 -14 -15 -17 -19 -19 -19 -19 -19 -18 -19 -19 -18 -19 -19 -19 -19 -19 -19 -19 -19 
-19 -19 -19 -19 -19 -19 -19 -19 -18 -18 -18 -18 -18 -18 -18 -19 -19 -19 -18 -17 -17 -20 -24 -31 -44 -55 -68 -77 -94 -105 -114 -121 -123 -115 -105 -82 -71 -59 -38 -30 -22 -11 -12 -6 -10 -15 -15 -19 -19 -19 -18 -19 -18 -19 -19 -19 -19 -19 -19 -19 -19 -19 -19 -19 
-19 -19 -19 -19 -19 -19 -19 -18 -18 -18 -18 -18 -18 -18 -18 -18 -18 -17 -17 -17 -17 -17 -21 -23 -36 -47 -59 -73 -81 -94 -104 -102 -106 -110 -94 -76 -60 -48 -34 -27 -14 -7 -4 -9 -8 -11 -16 -19 -19 -19 -19 -18 -18 -19 -19 -19 -19 -19 -19 -19 -19 -19 -19 -19 
-19 -19 -19 -19 -19 -19 -18 -18 -18 -18 -18 -17 -18 -18 -18 -17 -16 -16 -17 -16 -17 -17 -16 -21 -31 -40 -53 -63 -74 -82 -89 -93 -89 -87 -77 -65 -57 -42 -22 -20 -8 -1 0 -5 -8 -11 -13 -19 -19 -19 -19 -18 -18 -19 -19 -19 -19 -19 -19 -19 -19 -19 -19 -19 
-19 -19 -19 -19 -19 -19 -18 -18 -18 -17 -17 -17 -17 -17 -17 -14 -14 -16 -14 -14 -14 -14 -14 -14 -25 -34 -44 -57 -67 -79 -79 -78 -75 -73 -61 -62 -48 -39 -20 -17 -12 -7 -4 -9 -10 -13 -14 -19 -21 -18 -18 -18 -18 -18 -19 -19 -19 -19 -19 -19 -19 -19 -19 -19 
-19 -19 -19 -19 -19 -19 -18 -18 -18 -17 -17 -17 -17 -17 -16 -14 -14 -14 -14 -11 -11 -11 -11 -11 -14 -28 -33 -40 -51 -60 -68 -61 -58 -55 -44 -40 -33 -22 -9 -5 0 -3 -2 -6 -6 -11 -15 -21 -22 -21 -18 -18 -18 -18 -18 -18 -19 -19 -19 -19 -19 -19 -19 -19 
-19 -19 -19 -19 -19 -18 -18 -18 -17 -17 -17 -17 -17 -17 -16 -14 -14 -13 -11 -11 -10 -10 -10 -10 -11 -11 -27 -33 -38 -48 -54 -49 -47 -44 -37 -29 -24 -13 -2 -5 -4 -3 -4 -7 -11 -13 -18 -24 -23 -21 -19 -18 -18 -18 -13 -18 -19 -19 -19 -19 -19 -19 -19 -19 
-19 -19 -19 -19 -19 -19 -18 -18 -18 -17 -17 -17 -17 -17 -14 -14 -14 -13 -11 -10 -10 -10 -10 -10 -10 -11 -11 -23 -31 -33 -39 -35 -34 -28 -23 -18 -10 -4 2 1 1 -2 -6 -10 -12 -11 -15 -22 -25 -23 -16 -15 -13 -13 -8 -13 -14 -15 -15 -19 -19 -19 -19 -19 
-19 -19 -19 -19 -19 -19 -18 -18 -18 -17 -17 -17 -17 -17 -14 -14 -14 -13 -11 -10 -10 -10 -10 -10 -10 -10 -11 -11 -24 -25 -27 -25 -26 -25 -16 -14 -10 -2 2 0 -2 -6 -9 -13 -19 -19 -23 -29 -28 -20 -18 -11 -9 -8 -2 -8 -9 -9 -15 -15 -19 -19 -19 -19 
-19 -19 -19 -19 -19 -19 -18 -18 -18 -18 -18 -17 -18 -17 -17 -14 -13 -11 -11 -10 -10 -10 -9 -9 -10 -10 -11 -11 -11 -23 -19 -17 -15 -18 -9 -3 -7 -7 3 -3 -3 -6 -12 -17 -18 -26 -27 -31 -25 -18 -16 -8 -6 -5 2 -2 -3 -4 -9 -9 -15 -19 -19 -19 
-19 -19 -19 -19 -19 -19 -19 -18 -18 -18 -18 -18 -18 -14 -17 -14 -14 -14 -11 -10 -10 -10 -10 -10 -10 -10 -11 -14 -11 -11 -17 -13 -8 -12 -5 -3 -4 -7 0 -8 -8 -11 -13 -19 -22 -26 -32 -30 -24 -22 -15 -7 -3 -2 3 1 0 0 -4 -9 -9 -15 -19 -19 
-19 -19 -19 -19 -19 -19 -19 -19 -18 -16 -16 -14 -14 -14 -14 -14 -14 -11 -14 -11 -11 -10 -10 -10 -10 -11 -14 -14 -14 -16 -11 -17 -11 -9 -6 -1 -8 -8 0 -11 -11 -13 -19 -23 -29 -33 -29 -31 -26 -20 -15 -7 -4 0 5 2 6 6 0 -4 -9 -15 -15 -19 
-19 -19 -19 -19 -19 -19 -19 -19 -17 -11 -14 -14 -14 -10 -13 -11 -11 -13 -11 -14 -11 -11 -11 -10 -11 -14 -14 -16 -17 -17 -17 -13 -13 -11 -10 -4 -8 -10 -1 -13 -17 -14 -24 -29 -30 -33 -32 -28 -22 -17 -10 -9 -3 0 10 7 8 6 6 0 -4 -9 -15 -19 
-19 -19 -19 -19 -19 -16 -14 -11 -9 -6 -6 -8 -7 -5 -10 -10 -10 -11 -10 -11 -14 -14 -11 -11 -14 -14 -16 -17 -17 -17 -17 -17 -12 -4 -7 -4 -8 -8 -2 -10 -15 -20 -25 -30 -33 -39 -35 -29 -25 -19 -12 -5 0 0 3 10 12 8 6 0 -4 -9 -15 -19 
-19 -19 -19 -19 -16 -16 -9 -5 -5 0 0 0 -1 -3 -6 -10 -10 -10 -11 -10 -11 -14 -14 -14 -14 -14 -17 -17 -17 -14 -15 -12 -12 -3 -6 -2 0 -6 -4 -12 -16 -18 -29 -32 -36 -40 -35 -32 -27 -21 -20 -13 -5 0 0 5 5 2 -1 0 -4 -9 -15 -19 
-19 -19 -19 -16 -10 -9 -2 0 0 6 6 4 4 2 0 -3 -7 -10 -10 -11 -14 -13 -16 -14 -17 -17 -17 -17 -14 -14 -9 -8 -7 1 3 1 2 -4 -1 -11 -17 -17 -24 -34 -36 -34 -29 -29 -25 -25 -16 -16 -7 -1 0 2 0 0 2 0 0 -4 -9 -15 
-19 -19 -16 -10 -9 -2 2 5 6 12 10 11 12 8 2 1 -3 -9 -10 -10 -11 -14 -17 -17 -17 -17 -17 -14 -10 -9 -3 -3 1 9 5 5 7 0 2 -6 -14 -19 -23 -31 -35 -37 -36 -36 -37 -38 -31 -27 -20 -14 -11 -9 -12 -13 -8 -13 -12 -9 -15 -19 
-19 -16 -16 -10 -6 0 6 10 12 18 17 18 18 15 8 4 -1 -3 -10 -10 -11 -16 -17 -17 -17 -17 -14 -10 -9 -5 0 3 9 13 10 11 13 8 4 3 -6 -14 -19 -27 -32 -37 -33 -40 -43 -39 -37 -37 -27 -27 -24 -21 -20 -22 -18 -14 -18 -18 -15 -19 
-19 -16 -10 -6 0 5 6 12 16 19 19 19 19 19 15 9 2 -3 -10 -10 -14 -17 -17 -17 -17 -13 -14 -9 -4 0 8 11 14 19 17 17 19 13 9 4 0 -7 -17 -22 -30 -35 -39 -36 -40 -42 -43 -48 -42 -39 -36 -33 -31 -34 -25 -23 -20 -19 -23 -19 
-19 -16 -10 -6 0 6 12 19 19 27 24 27 23 21 18 12 3 -1 -8 -10 -10 -11 -17 -17 -17 -14 -10 -6 0 7 11 17 19 24 22 22 21 19 16 9 4 -2 -14 -19 -27 -33 -36 -45 -48 -52 -53 -48 -53 -51 -50 -46 -44 -35 -37 -36 -34 -31 -24 -22 
-19 -16 -10 -6 0 5 12 18 21 31 30 24 23 19 15 10 3 -2 -10 -10 -13 -17 -17 -17 -17 -14 -9 -3 1 9 14 20 22 27 25 27 25 21 16 9 4 0 -11 -18 -23 -31 -39 -42 -46 -52 -51 -59 -63 -63 -60 -56 -55 -48 -44 -41 -35 -33 -30 -23 
-16 -10 -6 0 2 10 15 19 27 39 37 31 24 21 18 12 6 0 -4 -10 -13 -17 -17 -17 -17 -13 -9 -3 3 11 16 22 27 33 31 29 27 21 18 11 7 0 -9 -14 -19 -27 -37 -46 -49 -51 -58 -62 -69 -72 -72 -68 -60 -53 -52 -43 -41 -39 -32 -23 
-19 -16 -10 -6 0 5 12 18 20 30 26 23 19 18 12 6 0 -2 -10 -10 -11 -16 -17 -17 -13 -9 -5 0 7 12 19 24 29 34 33 31 29 23 19 13 9 2 -5 -15 -19 -31 -39 -49 -57 -59 -67 -70 -76 -81 -80 -78 -73 -65 -63 -56 -53 -45 -39 -31 
-19 -16 -10 -6 0 5 10 15 18 20 19 19 18 17 10 6 0 -5 -10 -14 -17 -17 -18 -17 -17 -13 -9 -3 2 9 15 20 27 31 29 25 23 19 15 9 4 0 -6 -14 -19 -23 -31 -39 -48 -57 -58 -65 -73 -78 -78 -77 -73 -65 -57 -56 -47 -39 -33 -24 
-19 -16 -10 -6 0 2 5 12 12 18 17 16 12 13 8 2 0 -7 -13 -14 -17 -18 -18 -17 -17 -13 -9 -3 2 9 14 20 23 26 24 25 22 17 13 9 4 0 -9 -14 -18 -21 -29 -36 -45 -56 -62 -69 -76 -76 -77 -77 -77 -72 -63 -56 -49 -40 -34 -26 
-19 -16 -16 -10 -6 0 2 5 6 12 10 10 10 8 1 -3 -8 -10 -14 -17 -18 -18 -18 -18 -17 -13 -9 -3 1 7 9 14 17 22 19 19 17 14 11 7 0 -8 -14 -16 -16 -20 -26 -34 -42 -51 -60 -61 -68 -70 -76 -71 -72 -64 -62 -55 -48 -39 -34 -26 
-19 -19 -16 -10 -9 -6 0 0 1 5 3 2 2 1 -3 -5 -10 -17 -17 -19 -19 -18 -18 -18 -17 -13 -13 -7 -3 2 9 10 11 16 11 12 14 9 5 -1 -8 -10 -15 -17 -18 -18 -25 -25 -33 -41 -51 -58 -59 -61 -69 -62 -63 -62 -56 -49 -41 -34 -33 -24 
-19 -19 -19 -16 -10 -9 -6 -5 -5 0 -2 -2 -2 -3 -9 -11 -17 -17 -19 -19 -19 -19 -18 -18 -18 -17 -14 -9 -9 -3 1 4 4 9 5 5 6 0 -4 -5 -11 -15 -17 -19 -19 -19 -18 -25 -33 -34 -43 -52 -53 -54 -61 -56 -56 -55 -49 -41 -41 -34 -27 -24 
-19 -19 -19 -19 -16 -16 -10 -9 -9 -6 -9 -9 -9 -11 -16 -19 -19 -19 -19 -19 -19 -19 -19 -19 -18 -18 -18 -14 -9 -9 -3 -3 -3 1 -2 -2 0 -7 -7 -11 -18 -18 -19 -19 -19 -19 -19 -19 -27 -34 -36 -43 -45 -47 -53 -47 -49 -48 -41 -41 -34 -28 -26 -23 
-19 -19 -19 -19 -19 -16 -16 -16 -16 -10 -14 -16 -16 -16 -19 -19 -19 -19 -19 -19 -19 -19 -19 -19 -18 -18 -18 -17 -14 -14 -9 -9 -8 -4 -8 -9 -7 -13 -13 -17 -18 -19 -19 -19 -19 -19 -19 -19 -19 -29 -29 -36 -38 -39 -45 -39 -40 -39 -34 -34 -28 -26 -24 -23 
-19 -19 -19 -19 -19 -19 -19 -19 -19 -16 -19 -19 -19 -19 -19 -19 -19 -19 -19 -19 -19 -19 -19 -19 -19 -18 -18 -18 -18 -14 -14 -14 -14 -10 -14 -14 -13 -15 -19 -19 -19 -19 -19 -19 -19 -19 -19 -19 -19 -19 -29 -30 -30 -32 -39 -33 -34 -34 -33 -27 -26 -24 -23 -23 
-19 -19 -19 -19 -19 -19 -19 -19 -19 -19 -19 -19 -19 -19 -19 -19 -19 -19 -19 -19 -19 -19 -19 -19 -19 -19 -19 -19 -18 -18 -18 -18 -18 -15 -18 -18 -18 -19 -19 -19 -19 -19 -19 -19 -19 -19 -19 -19 -19 -19 -19 -22 -23 -23 -31 -24 -26 -26 -24 -24 -23 -23 -23 -21 
