35 33 38 34 35 33 35 33 38 38 34 37 33 38 38 33 33 38 33 38 33 33 38 38 35 38 36 33 33 36 38 35 38 38 33 33 38 33 38 33 33 38 38 34 38 35 38 38 34 36 34 36 34 33 33 36 38 35 38 38 34 34 33 34 
33 36 33 33 33 38 34 33 35 33 33 33 33 33 38 38 34 38 38 33 34 33 33 34 38 36 38 38 34 34 34 38 34 34 34 38 35 34 38 33 38 33 33 38 36 38 33 36 34 36 33 38 38 38 34 33 33 34 38 36 38 33 36 34 
38 33 33 38 35 34 38 33 35 33 33 34 33 35 33 34 35 33 35 34 34 35 33 36 34 34 38 33 38 35 36 38 34 38 38 38 33 35 33 33 33 34 38 35 34 34 38 34 33 38 33 34 38 34 34 34 38 34 33 33 33 34 33 38 
33 38 38 33 33 33 38 37 32 38 33 34 34 38 34 35 33 33 33 38 33 34 33 34 33 33 34 33 34 33 38 34 33 33 38 35 38 35 36 33 38 33 38 38 34 33 34 38 38 34 33 33 38 38 33 38 38 34 33 34 33 33 38 35 
33 33 38 33 37 32 32 31 34 33 34 38 38 37 34 33 33 36 36 34 33 36 38 33 33 38 35 33 34 34 34 33 38 33 34 35 34 33 38 33 34 34 34 33 36 33 33 33 33 38 34 36 38 38 36 34 38 33 33 33 33 36 33 34 
38 33 35 33 37 34 31 35 31 31 33 33 34 35 32 33 36 38 33 33 38 38 34 35 33 34 33 33 38 33 38 38 38 38 38 33 38 33 33 34 33 35 34 38 38 33 33 38 38 33 33 38 38 34 34 33 33 38 38 36 38 34 38 34 
33 33 38 37 33 31 32 30 31 28 28 32 32 31 30 33 32 36 32 36 33 34 38 38 34 34 38 34 38 34 38 34 34 38 38 34 34 36 34 38 34 35 33 34 38 38 33 33 34 33 34 33 34 38 40 34 34 38 38 33 38 33 38 38 
38 38 33 34 33 30 30 34 30 30 28 30 30 29 30 31 34 37 37 32 34 33 34 36 33 36 35 33 34 33 38 38 38 33 33 38 33 34 38 33 33 38 38 38 33 34 33 35 35 33 42 42 40 40 51 46 40 46 40 34 33 34 34 33 
33 33 33 33 33 35 31 33 27 31 31 28 26 28 27 30 30 31 37 31 37 34 33 38 36 34 34 34 35 38 38 33 38 33 38 34 33 38 38 38 38 38 33 34 38 33 38 34 33 43 43 51 51 51 59 53 50 51 47 40 33 38 34 34 
33 34 38 32 37 33 35 27 26 31 27 28 29 28 29 28 29 34 31 37 31 38 36 33 33 33 38 34 38 38 34 38 33 34 33 38 33 34 33 38 34 34 34 33 38 33 33 38 40 51 53 60 59 60 69 61 59 63 50 50 46 34 36 38 
35 33 33 33 32 33 32 31 32 26 26 28 30 31 27 27 27 27 29 35 35 32 37 38 36 38 33 38 36 38 38 34 38 38 36 33 34 33 38 33 33 38 33 34 33 36 38 46 51 53 61 68 72 66 80 68 69 69 59 52 52 41 33 33 
33 33 34 34 34 33 32 29 30 26 27 28 28 28 26 27 26 31 28 30 35 31 32 33 38 37 33 38 38 34 35 34 34 33 38 35 33 34 38 38 38 38 38 34 33 36 40 41 51 59 68 76 75 77 85 77 75 76 68 59 51 41 44 33 
33 38 33 33 33 33 36 31 31 28 26 26 26 26 26 27 26 27 26 31 34 31 38 38 35 33 34 37 33 33 37 33 33 34 33 33 34 38 38 33 38 38 33 36 35 38 41 51 59 66 75 76 87 87 96 85 85 78 75 69 58 51 41 35 
38 38 38 33 33 33 32 33 34 28 28 27 28 26 26 26 26 27 33 29 33 31 32 33 38 38 38 38 38 33 38 33 38 34 38 36 33 38 35 34 33 38 34 33 33 38 43 51 60 67 76 87 96 96 102 96 95 86 78 69 60 51 43 38 
35 35 35 33 33 32 36 31 29 33 27 26 26 24 25 26 25 26 26 27 29 33 33 35 38 37 37 36 34 38 35 38 35 38 34 38 33 34 38 33 33 34 34 34 34 34 41 51 64 69 78 83 97 101 113 100 97 83 78 69 64 50 41 34 
38 38 38 33 38 33 32 31 29 29 28 26 26 26 25 25 26 26 25 26 26 26 26 26 31 28 37 33 37 37 38 38 33 38 34 33 33 33 34 38 34 33 38 38 38 40 51 58 69 78 87 97 105 112 125 113 100 91 84 76 68 58 52 41 
33 38 33 38 33 33 37 37 31 35 33 27 26 31 26 26 24 22 24 25 20 24 23 25 25 26 26 36 30 34 38 38 33 33 38 33 33 36 38 34 34 34 38 36 33 34 48 52 61 71 81 94 98 110 115 103 100 89 78 70 60 52 42 38 
34 38 38 38 34 38 38 31 30 29 29 29 32 28 34 27 27 25 20 21 18 18 18 23 23 22 26 26 26 29 37 38 38 38 33 38 36 38 33 38 38 33 34 33 33 34 41 56 67 70 84 91 101 101 114 102 102 89 79 70 60 55 44 38 
38 33 33 33 33 37 32 32 37 31 38 36 36 37 40 40 37 29 27 21 21 15 13 13 16 20 19 23 26 29 29 38 38 38 33 36 33 33 33 34 33 38 36 38 33 34 42 52 62 74 82 88 97 98 102 97 93 84 83 76 63 51 41 34 
38 33 38 33 34 34 38 33 34 38 40 44 49 51 51 45 46 44 35 28 22 13 13 12 13 14 15 16 20 26 27 30 38 35 38 34 34 38 38 38 34 34 38 34 36 34 42 45 54 65 79 87 89 89 98 84 89 82 77 68 52 50 41 36 
34 33 38 33 34 36 34 34 41 43 48 55 57 59 66 63 55 51 40 37 27 18 13 10 7 7 12 13 13 25 26 30 36 33 33 34 38 34 38 33 33 33 38 33 37 38 40 50 56 64 70 80 80 81 93 80 81 82 71 60 54 48 34 33 
38 33 38 33 38 33 34 39 46 51 57 64 70 71 76 73 70 63 53 44 37 24 13 5 3 8 6 12 16 20 25 29 36 35 39 38 34 38 34 34 35 34 38 37 33 38 37 39 52 63 63 73 72 73 84 76 72 71 60 59 45 38 33 33 
38 34 34 38 38 33 41 40 51 60 65 75 79 80 86 81 80 73 64 55 40 22 12 4 3 0 7 5 10 13 24 25 34 36 35 36 38 36 38 36 38 33 34 38 38 35 37 39 40 53 53 64 64 66 78 69 64 63 53 51 40 38 38 33 
35 33 33 38 34 34 38 46 54 67 72 79 89 93 97 95 89 80 71 57 51 30 15 5 1 0 0 4 7 14 21 25 31 36 36 38 37 39 40 39 36 37 33 36 36 35 38 39 45 43 52 57 61 60 72 55 59 53 51 42 43 39 37 37 
33 38 33 38 34 33 39 47 55 65 76 88 94 101 112 103 103 91 79 64 54 38 24 4 0 0 5 3 12 15 25 26 33 35 37 38 38 40 38 38 39 38 39 38 34 34 36 38 39 41 44 49 47 51 57 51 47 43 41 44 42 36 34 34 
38 33 34 34 33 34 39 47 55 68 75 85 96 108 114 114 106 97 80 69 53 42 25 12 7 1 6 5 12 14 25 26 31 34 39 38 39 39 38 40 40 39 38 35 37 38 38 38 39 42 44 44 49 51 51 48 43 43 41 39 39 36 34 33 
38 33 38 34 35 39 43 54 65 74 86 98 107 115 128 126 119 108 93 79 65 51 37 28 13 6 11 6 13 18 24 30 36 38 39 40 39 43 38 43 39 39 38 35 38 38 38 41 39 40 44 49 49 47 51 43 48 42 41 39 38 38 35 33 
38 34 33 34 38 33 38 44 52 67 76 83 96 105 115 114 111 101 86 76 60 45 34 23 17 13 12 14 15 19 26 31 34 38 39 39 39 38 42 38 40 40 36 35 33 34 38 38 42 40 44 48 42 43 49 45 43 47 40 39 40 34 33 38 
34 33 33 38 34 35 42 47 56 64 77 88 95 99 109 109 106 97 92 75 62 51 38 25 23 14 15 17 20 23 29 32 33 37 40 41 39 41 40 42 38 38 38 34 38 33 38 38 39 39 40 42 47 46 48 43 41 41 42 39 39 35 33 33 
34 38 38 33 34 38 38 45 55 63 74 82 88 92 99 100 101 91 83 77 63 53 41 34 26 25 24 22 28 30 32 38 39 38 38 43 40 39 38 38 42 40 39 38 37 34 34 35 38 38 39 40 40 41 43 42 42 41 40 40 34 33 34 35 
34 33 36 33 36 33 38 41 48 54 64 76 81 85 92 90 92 90 79 70 63 51 40 35 29 29 26 30 28 33 36 38 40 37 37 39 38 37 39 38 38 37 35 38 34 38 34 38 38 39 43 39 41 43 45 44 44 43 40 38 38 34 33 38 
38 33 34 38 36 34 33 38 45 52 58 68 70 74 80 79 78 80 72 67 61 52 39 37 35 32 30 34 39 36 37 39 37 37 41 40 34 38 38 38 34 39 38 39 34 38 34 38 38 39 40 44 39 46 42 39 39 39 38 40 38 33 38 38 
33 34 33 34 34 38 38 37 40 47 48 56 60 64 69 67 68 70 65 62 54 46 44 38 36 36 39 35 40 38 38 39 39 37 38 38 39 39 38 38 37 37 36 34 33 38 38 38 35 40 38 40 38 41 40 41 41 38 38 35 38 34 38 37 
33 33 34 33 38 38 33 38 38 41 40 47 53 52 59 55 56 56 51 53 43 40 42 41 40 38 37 43 38 40 39 38 38 35 38 39 32 37 37 37 31 36 35 38 34 33 35 38 40 38 40 44 40 40 43 43 40 38 39 40 38 38 38 34 
38 33 34 33 33 33 34 38 34 34 39 40 41 47 51 48 45 46 43 40 40 40 38 43 42 42 39 43 40 41 39 41 37 34 33 33 32 30 28 35 28 34 29 37 37 32 37 36 40 41 38 40 38 46 46 39 41 38 42 40 37 38 34 33 
34 38 36 38 33 33 34 38 33 34 34 35 33 33 39 35 38 34 33 37 35 38 42 42 39 44 44 41 39 40 38 35 37 34 32 31 30 28 27 28 26 26 30 30 31 36 38 39 38 40 38 46 41 48 48 42 39 39 42 40 37 38 33 37 
33 33 38 34 38 38 38 38 34 38 38 33 33 38 34 38 33 33 34 38 38 41 38 39 40 46 42 44 38 38 42 38 33 34 31 30 28 25 26 31 25 25 30 30 30 32 36 37 38 43 39 43 44 46 44 46 40 41 40 38 42 38 38 33 
38 38 33 34 38 38 36 38 34 35 33 34 38 33 38 33 38 33 38 34 40 38 38 39 39 45 44 41 39 40 38 39 38 31 29 27 25 25 25 24 26 25 27 34 29 34 31 38 36 41 39 46 43 42 46 43 44 42 44 40 38 35 38 37 
38 38 38 38 35 38 33 34 38 36 38 38 38 35 38 33 34 38 38 37 38 38 38 41 39 40 47 47 40 40 40 36 31 35 27 28 26 24 23 26 28 25 24 28 28 29 30 34 39 41 39 41 44 44 50 44 44 40 39 41 39 38 34 34 
34 38 37 33 34 33 38 38 36 38 38 37 38 38 34 37 35 38 34 39 38 38 38 40 41 39 42 39 44 38 39 35 35 29 31 27 24 25 24 22 24 25 27 25 31 29 33 34 36 39 41 46 46 51 49 44 46 46 44 42 41 38 38 38 
38 33 33 34 38 38 35 38 37 34 38 38 37 36 38 38 38 34 38 40 38 38 42 40 40 40 41 40 39 41 40 34 35 31 32 29 25 24 23 22 22 25 25 31 26 32 33 31 38 40 42 48 48 50 53 51 48 49 40 43 38 34 38 38 
33 37 38 38 38 33 36 37 35 38 34 35 34 38 34 36 37 34 38 39 40 40 38 40 43 40 38 40 40 39 34 36 34 33 31 31 25 25 28 26 26 27 25 25 30 33 34 34 40 39 41 53 50 53 56 52 48 50 46 42 39 38 38 34 
37 36 33 37 38 34 38 38 38 35 38 38 34 38 38 37 38 34 40 38 40 42 40 45 38 44 40 40 39 38 38 36 33 32 31 30 25 27 24 27 24 24 22 25 26 29 26 34 37 38 43 50 51 55 52 56 53 53 51 44 45 36 38 34 
38 33 33 34 34 33 38 37 33 35 38 38 38 38 38 37 34 38 34 38 38 40 40 40 39 45 40 43 38 38 38 38 34 33 36 31 31 28 28 27 26 25 25 30 26 25 30 34 37 42 47 51 50 55 56 56 57 50 45 43 44 39 36 37 
35 36 38 34 35 38 34 34 38 34 34 37 33 38 34 38 38 38 38 38 38 38 38 38 43 41 43 38 38 38 39 38 38 33 32 31 31 29 28 25 29 25 25 25 25 26 28 35 38 41 47 44 54 50 55 56 51 51 47 45 43 39 36 34 
34 33 38 34 33 38 34 33 38 38 35 33 38 38 37 34 34 34 40 39 40 39 40 39 39 39 39 38 38 38 38 38 38 38 32 31 30 29 31 33 27 27 27 31 25 26 31 29 36 37 35 43 42 40 40 48 50 45 53 45 46 41 40 34 
34 38 33 37 33 33 35 38 38 33 33 33 33 38 38 38 37 34 38 38 38 39 38 38 43 38 40 41 38 38 38 37 36 34 33 32 31 36 31 29 28 30 25 28 25 25 32 29 28 33 21 20 24 22 19 28 27 38 33 47 42 42 39 33 
38 35 34 33 33 34 38 34 38 37 37 37 38 33 36 33 38 38 38 38 36 38 38 40 40 39 40 38 38 34 38 38 37 38 38 33 37 35 30 30 29 33 26 27 25 25 25 25 23 16 12 8 10 10 8 15 12 19 26 28 44 42 39 39 
38 38 33 34 33 34 33 36 37 33 34 33 34 34 38 38 36 38 38 38 38 38 38 40 38 36 38 38 40 34 38 33 38 34 35 33 32 37 32 30 34 35 28 30 27 28 24 15 8 1 -3 -11 -5 -7 -12 -1 -2 1 11 8 22 41 40 38 
33 33 38 33 38 34 34 38 34 34 34 38 34 34 36 38 38 38 38 35 34 34 38 40 38 39 37 38 38 38 34 38 38 33 37 34 34 36 32 37 31 31 35 33 31 21 21 9 -3 -6 -22 -30 -27 -30 -30 -21 -21 -14 -1 10 10 25 39 38 
38 38 33 38 36 36 38 33 38 37 37 38 34 38 38 38 38 34 38 38 38 34 38 34 40 34 37 38 36 34 34 36 33 38 37 38 38 34 32 32 32 31 34 30 28 21 7 0 -9 -25 -34 -51 -51 -50 -53 -43 -38 -36 -20 -4 5 17 25 34 
38 34 33 35 34 34 38 38 33 38 38 34 33 34 38 38 34 33 34 38 38 34 33 34 38 38 38 38 38 34 34 34 38 38 34 34 36 33 33 35 33 33 37 36 29 25 6 -4 -19 -36 -52 -58 -73 -71 -77 -65 -55 -39 -38 -17 0 8 25 37 
34 35 35 34 33 35 38 33 33 38 34 38 33 34 34 33 38 33 34 35 34 33 38 34 35 35 34 38 38 38 34 33 38 38 33 36 38 38 36 33 37 38 32 36 31 23 6 -6 -22 -42 -54 -73 -87 -98 -98 -84 -72 -54 -36 -24 -6 7 22 32 
34 34 38 38 34 35 33 33 38 33 38 38 37 38 36 38 36 38 37 38 38 33 38 34 34 35 36 38 38 34 34 38 38 34 34 38 38 37 37 33 34 38 32 36 28 20 2 -11 -25 -44 -61 -77 -100 -113 -119 -105 -83 -64 -45 -26 -13 0 14 32 
34 35 34 34 33 33 38 36 33 38 34 33 34 33 33 38 38 34 34 38 37 38 38 38 38 38 34 35 38 38 34 33 34 33 34 38 33 38 38 33 33 34 32 33 31 12 -2 -18 -33 -50 -73 -88 -103 -126 -128 -113 -91 -74 -56 -33 -16 -2 8 23 
38 33 38 34 38 35 33 33 33 34 34 33 35 35 33 34 34 38 33 38 34 34 33 37 38 34 38 36 34 35 34 38 38 38 34 34 38 34 34 38 33 33 38 38 34 25 6 -6 -22 -40 -62 -76 -89 -109 -113 -104 -82 -61 -41 -28 -10 0 20 31 
33 33 33 33 34 36 38 34 38 34 33 38 35 34 34 34 34 37 38 33 37 33 38 34 33 38 38 38 38 38 34 35 38 34 38 34 38 38 35 34 34 34 34 38 38 25 11 -2 -18 -38 -53 -73 -87 -91 -98 -86 -77 -62 -46 -24 -10 3 22 32 
38 36 33 34 35 34 33 34 34 34 33 34 38 37 34 38 33 33 38 34 38 38 38 34 38 38 38 38 33 34 34 38 36 38 38 38 34 37 38 36 33 35 38 38 34 30 13 -1 -12 -33 -50 -51 -65 -75 -76 -66 -64 -48 -39 -20 -3 2 23 32 
35 35 33 36 38 34 33 33 33 38 33 33 38 33 33 33 37 38 38 34 38 38 36 33 33 33 38 38 38 35 38 38 38 33 34 33 38 33 33 38 33 34 33 37 38 38 15 11 0 -12 -30 -47 -41 -52 -55 -46 -46 -38 -20 -8 2 16 24 32 
36 38 38 36 34 33 38 33 35 38 38 38 38 38 34 33 34 38 33 33 34 33 33 38 34 38 34 38 38 38 38 38 35 38 35 38 33 34 34 34 33 33 37 33 35 38 33 14 0 0 -12 -25 -28 -31 -37 -30 -28 -22 -12 2 9 17 32 37 
38 33 38 33 34 33 34 38 34 34 38 36 38 33 38 38 33 38 38 33 38 38 33 38 38 33 38 38 33 38 38 33 38 35 38 34 34 37 33 33 34 38 38 33 35 34 36 33 14 3 0 -4 -4 -13 -21 -11 -4 -3 2 7 24 30 33 33 
38 38 33 34 38 33 34 38 33 34 38 33 35 33 34 38 34 38 34 38 34 33 36 33 38 34 33 38 34 33 38 34 33 38 37 34 33 38 38 37 34 34 33 33 33 38 38 38 38 19 16 5 3 0 -2 0 2 2 20 22 33 37 33 33 
38 34 33 34 38 34 38 33 34 34 38 38 38 38 38 38 38 35 34 33 38 34 33 38 33 37 33 34 38 33 34 35 38 38 38 38 38 37 34 34 33 38 34 33 36 33 38 33 34 38 23 23 22 15 11 23 24 23 23 34 32 33 33 38 
33 34 38 34 33 38 38 33 34 38 33 38 38 38 38 33 34 33 38 34 34 35 38 33 38 34 33 33 33 34 38 33 38 38 36 37 38 33 36 33 33 38 33 33 34 33 35 34 33 33 34 36 32 37 23 31 32 33 37 32 38 35 34 34 
