3 -82 -81 64 -118 72 -22 63 109 -91 -78 -45 3 91 -6 -36 
-82 -37 -94 -62 32 109 -68 -100 -37 93 6 126 -55 118 -114 -76 
78 36 68 47 -104 -39 -73 114 1 -71 27 -25 128 -92 -77 89 
-67 51 -3 63 100 -65 103 -11 118 121 48 -19 -9 -85 44 20 
-109 -19 -73 -22 -102 -36 -73 42 100 102 87 46 2 -27 -42 -23 
51 52 42 -39 8 -103 65 -22 76 82 -50 118 39 -73 -44 109 
-34 83 43 -42 -20 -18 120 29 101 -14 55 -22 90 93 96 -10 
80 9 -30 43 76 -113 38 -109 -20 -79 20 111 34 99 -100 -2 
-93 -63 99 -75 -86 45 -109 -81 -68 -85 -87 -85 -41 48 -45 -62 
-126 80 -77 71 14 -55 34 34 105 -27 87 -89 -120 -43 82 -18 
3 62 19 6 -91 -118 14 14 -16 66 -80 -66 -19 -45 9 21 
-112 47 62 19 -34 -18 -90 55 9 -122 -65 51 37 -16 -46 22 
-113 -40 2 46 77 -95 7 -79 -109 -68 76 92 -9 37 -7 -124 
31 -25 -13 31 60 31 -97 91 90 90 47 -82 -110 -80 -36 -21 
1 -25 -54 75 1 -113 60 -25 1 17 -70 -128 -23 -96 18 -11 
31 75 90 -99 46 -99 1 -40 90 -25 -54 60 -70 91 -69 -40 
