13 -69 -61 73 -104 74 -24 58 103 -91 -79 -46 0 85 -8 -38 
-69 -18 -67 -42 42 110 -69 -100 -39 87 2 120 -56 113 -114 -77 
93 59 97 70 -84 -27 -67 108 -1 -72 23 -26 123 -90 -77 85 
-54 67 21 79 108 -59 97 -13 112 115 44 -19 -9 -83 42 18 
-95 -7 -46 -10 -88 -31 -74 38 94 96 83 43 1 -25 -41 -23 
60 61 65 -27 18 -103 60 -24 71 78 -49 115 39 -69 -42 106 
-22 91 66 -30 -8 -13 114 25 95 -16 51 -22 87 91 93 -10 
88 26 -4 59 85 -106 34 -109 -22 -80 17 107 32 96 -97 -2 
-73 -37 128 -48 -66 54 -102 -82 -69 -85 -87 -85 -41 46 -43 -61 
-112 95 -50 86 24 -49 30 30 99 -29 82 -88 -118 -42 80 -18 
13 71 36 16 -78 -111 10 10 -18 61 -81 -66 -19 -43 9 20 
-105 49 71 22 -29 -20 -90 50 5 -122 -65 48 36 -14 -42 22 
-113 -42 5 42 72 -95 3 -80 -109 -69 71 87 -9 36 -5 -121 
27 -27 -15 27 55 27 -97 85 85 85 42 -82 -108 -79 -35 -21 
-1 -27 -55 70 -1 -113 55 -27 -1 13 -71 -128 -24 -95 16 -12 
27 70 85 -99 42 -99 -1 -42 85 -27 -55 55 -71 85 -69 -42 
