19 -98 101 5 34 -28 34 0 89 101 5 47 0 61 47 -58 -43 89 -84 89 -43 -58 61 89 19 75 34 -84 -84 34 75 19 89 61 -58 -43 89 -84 89 -43 -58 47 75 0 47 19 101 101 5 34 -16 34 5 -98 -98 34 75 19 101 75 -28 0 -84 -28 
-58 34 -43 -58 -16 75 19 5 61 -43 -84 -70 0 -98 75 101 -28 101 89 -98 0 -58 -70 -16 89 34 47 101 5 -28 0 75 0 -28 0 89 19 5 61 -58 101 -98 -43 75 34 47 -84 34 5 34 -84 61 47 89 -28 -84 -84 -28 89 34 47 -84 34 5 
89 -98 -16 101 47 34 75 -58 61 1 5 34 -98 34 -16 -16 19 -98 19 -16 -16 19 -98 34 0 0 47 -70 61 19 34 75 -28 101 61 75 -84 19 -58 -84 -70 0 89 19 0 5 75 -28 -98 89 -98 -28 75 5 0 5 75 -16 -84 -98 -70 5 -98 61 
-43 89 89 -28 -84 -28 85 71 -61 95 -89 30 17 89 19 34 -70 -98 -43 101 -98 0 -43 0 -84 -84 5 -42 0 -98 101 -28 -98 -70 47 19 89 19 34 -70 101 -58 89 90 -28 -70 -28 101 101 -28 -84 -58 61 47 -98 61 89 -16 -43 5 -58 -43 47 19 
-84 -98 75 -16 75 -88 -78 -105 54 -40 38 94 94 70 19 -84 0 34 34 0 -70 34 101 -70 -83 90 20 -96 -27 0 -15 -70 61 -58 0 19 5 -58 75 -58 0 6 -15 -82 35 -97 -57 -43 -70 75 -28 34 75 75 34 -28 61 -84 -58 -58 -98 34 -84 -28 
61 5 61 19 85 39 -109 77 -69 -86 -4 -14 61 65 -48 -43 47 61 -43 -43 75 89 5 20 -55 -26 -94 -67 78 -95 63 102 47 101 61 -98 75 -70 -98 -27 -56 20 7 91 77 -41 -41 48 47 -58 -43 61 75 -16 0 -84 -58 75 101 34 75 5 47 0 
-16 -16 89 71 -51 -97 -28 -87 -33 -118 -88 44 48 -57 -79 16 -16 47 0 34 -43 -16 103 105 -11 -24 52 11 66 10 51 -26 0 101 101 -16 -28 34 0 49 0 21 -55 -24 78 78 -40 -68 0 -43 5 -58 -28 101 -98 5 0 89 61 -84 75 -84 61 89 
89 75 -16 30 -1 -110 -87 68 -50 -41 -93 -23 -19 -98 -39 -48 60 101 75 -43 -16 -68 9 24 -39 25 13 -78 -23 -51 66 92 49 -69 -58 101 -43 -27 103 -55 -67 51 92 66 -39 -12 -67 21 20 -42 34 19 -58 0 -28 89 -84 89 -28 -16 -70 5 5 -58 
-70 -70 -58 -32 12 77 -60 26 -68 59 -5 -51 -76 -84 -80 -48 -17 34 101 -16 76 -13 -94 66 26 -7 -7 -6 14 54 108 -39 50 -57 61 -16 -70 102 77 78 78 106 -66 0 66 -53 52 -25 -96 48 19 0 0 5 34 75 -70 5 101 0 -84 61 5 -28 
-98 19 98 -104 78 3 80 -96 -115 27 -74 -28 -13 -60 48 -94 -75 101 19 101 -83 104 23 -92 -49 -61 98 -5 42 40 -9 106 -40 -27 -58 75 -58 -27 -56 91 -24 10 11 -37 67 -92 -92 78 -13 49 75 47 -28 47 75 61 0 89 -70 -70 89 -16 34 47 
19 -70 0 -5 -79 -4 1 -39 61 -116 -127 10 82 87 23 -91 -59 -98 19 61 49 -12 52 67 15 113 -59 115 17 83 67 0 78 91 34 -70 -27 -56 78 -67 -66 80 -50 -19 -62 40 96 80 0 65 63 5 101 -84 101 0 47 47 -28 47 61 5 -98 -70 
-84 -16 19 43 39 21 -33 -106 12 -111 -25 24 56 59 38 0 -58 75 -43 34 91 -95 -79 -91 83 17 -73 32 113 -35 -8 0 -12 -56 101 19 -84 0 49 91 105 107 68 15 -62 40 -78 -10 23 38 20 0 -58 89 -16 75 -70 -28 0 0 -28 -84 61 -43 
-84 89 -84 1 -37 -14 88 30 56 -65 -104 -89 4 -42 -11 69 19 34 -84 61 76 -55 106 108 -21 -89 -75 -5 -76 -77 0 -80 -81 -15 -98 -98 -28 102 91 -55 79 67 -91 41 27 82 -7 -21 24 -67 -95 -41 76 47 90 0 -28 5 -98 89 -84 19 -16 19 
47 75 101 -84 -61 -24 6 48 88 -75 -17 34 88 -53 14 87 -44 19 101 -28 62 -67 23 -92 13 110 1 111 14 -91 24 -66 64 -27 101 34 -43 102 20 -25 -94 67 12 -36 -90 82 41 0 -38 -66 -95 91 63 48 35 20 6 6 5 5 5 19 34 47 
19 19 19 0 -28 -75 79 24 -39 88 -2 -95 10 -103 -18 46 -98 -43 5 34 62 77 78 79 67 39 0 -37 -92 52 -24 105 0 101 0 75 -58 5 62 -96 -54 -23 -10 0 0 -7 -35 -63 94 38 -12 -94 36 -56 50 -56 35 -96 -27 34 89 -84 -58 -28 
47 61 101 -43 61 -28 -89 -102 -102 -65 0 -102 15 -30 -58 -58 -16 47 -70 47 0 -42 -42 0 51 -66 52 -10 -39 -39 -12 35 -84 34 -28 -70 -84 -58 0 91 -12 -80 94 81 109 -49 28 -78 67 24 11 24 66 -67 37 -25 -81 -95 -82 -42 34 -70 61 5 
-58 75 -84 89 -43 -43 75 100 33 98 73 -44 -44 88 -98 61 -70 -98 5 19 -44 -1 -44 34 20 -68 -39 105 -55 -81 0 5 -84 -58 101 -43 -58 34 47 -28 7 -25 51 39 -65 -38 109 -52 -92 0 -10 106 -66 78 -66 -94 9 8 -67 -26 -83 0 -16 89 
-16 101 75 101 -28 101 89 -98 0 -58 -71 -16 89 34 47 -98 19 -16 4 73 -2 -18 2 100 31 19 76 -27 -83 -83 -28 89 47 75 -70 61 34 61 -58 89 76 -96 0 -53 -53 0 -92 79 94 -52 80 39 67 -53 80 66 106 -12 -67 -68 -15 89 47 47 
47 -43 -84 -98 -58 34 -58 -98 101 -58 19 -58 -98 -98 -58 34 -43 -85 -86 -31 59 -19 -61 -47 0 98 18 -3 5 61 -58 89 61 75 -84 19 -43 -70 -58 5 -97 49 37 50 -94 9 -39 -67 -39 23 -65 80 67 94 -38 66 10 0 36 103 6 -43 -43 -16 
61 -70 89 -98 5 0 61 0 5 -98 75 -84 61 61 -58 -97 -44 73 72 -59 97 -78 39 26 93 41 68 -34 -59 5 -70 -58 47 5 61 -16 0 75 34 75 -16 -15 63 8 37 -55 -67 0 -66 -39 53 24 94 12 26 -91 94 -80 51 50 -82 90 -84 34 
0 -43 75 -43 5 19 5 -43 75 -58 -16 0 -27 -97 20 103 -70 -71 -99 28 -78 0 22 23 -13 -93 12 81 -101 100 47 -28 61 -98 -70 -84 75 -16 75 -98 -84 -98 48 -41 36 77 91 63 0 105 -39 0 0 -39 108 0 66 92 91 35 -42 61 -98 -70 
61 -98 61 -84 89 -58 -84 -16 -43 34 19 -97 91 -14 -26 78 76 -28 -31 82 92 0 6 -68 -41 91 -80 55 96 30 87 34 75 34 89 47 -98 75 -70 -98 -16 -43 34 20 -97 102 0 -15 91 91 0 9 -80 -66 53 79 0 22 -55 -14 -83 -43 -98 -58 
89 -16 -16 75 47 -84 89 -70 75 101 20 35 -67 -67 8 -13 62 5 59 -7 10 -83 -72 33 19 -98 77 -66 -104 -60 87 -98 19 34 -84 -98 -16 -43 19 -28 5 -70 -43 75 75 -28 -57 19 0 49 0 36 -39 -24 93 92 -24 -40 36 -14 48 -16 19 -58 
19 -98 -70 89 -28 -28 -98 -28 -43 90 -68 -95 8 51 9 106 -95 63 -72 -75 54 -96 -113 3 44 19 -96 -65 -103 -19 -2 -70 5 0 -84 -28 -43 61 101 61 -58 -28 -84 0 0 -70 0 -16 101 -57 -82 21 50 8 92 -95 50 -95 -96 34 101 75 -16 19 
-43 47 -70 47 -28 -98 75 34 19 34 49 91 -67 0 79 -23 92 6 -45 -91 92 77 73 -115 -75 -18 61 -67 39 -34 98 45 5 -16 -28 -16 5 47 -98 -16 75 -28 89 19 -28 -70 -84 -98 -84 -43 0 63 -68 20 -81 49 -14 -68 -97 101 101 -98 -70 -16 
89 -43 -16 -28 -98 5 47 47 0 102 -41 -25 -67 52 -79 -51 -80 50 -71 -46 -63 92 -28 19 19 -15 91 -52 -35 -74 60 -70 -43 -70 75 -58 0 -16 -84 19 75 89 34 -58 5 19 0 -84 0 19 5 -57 34 76 63 6 -97 -27 -28 -70 47 -98 -70 -98 
75 -98 75 -28 19 5 -70 5 20 -26 64 105 79 -10 39 26 -38 38 62 2 -102 -64 -96 37 -111 -109 38 -78 -62 -100 19 61 47 -28 34 47 0 89 -98 89 -16 34 34 -43 34 47 0 101 -70 -98 19 89 75 5 102 -98 75 -28 5 0 -84 -16 -16 -70 
61 0 -98 0 75 -84 -58 -58 -70 102 35 -55 51 -80 -23 0 11 0 -42 99 15 -91 -11 39 78 80 80 42 -6 -100 3 101 -58 -16 0 0 -43 -98 34 -58 19 89 -84 -58 -70 -98 61 0 101 -16 47 89 -98 -98 89 34 -28 89 -28 34 89 -98 -98 89 
-16 -70 -43 47 0 19 101 47 61 -57 107 104 -12 -80 -66 11 -53 -53 22 -43 -45 28 -50 -49 12 -49 -62 0 -60 -72 0 -84 -98 -43 89 75 -84 34 19 75 -16 -28 5 -84 101 -58 61 19 75 -28 -58 -16 89 47 89 -16 -58 -16 75 34 61 -43 -98 -70 
0 47 101 -58 0 61 -84 -12 65 -79 4 95 -38 55 -67 23 -94 9 -95 8 -84 18 -75 59 -34 98 17 -60 73 5 -58 89 34 -28 -84 89 34 0 -43 -84 89 61 34 5 0 -28 -43 -43 -58 -58 -58 -58 -58 -43 -28 -16 5 19 47 89 -98 -58 -16 19 
0 -84 34 -70 34 -84 0 69 -78 -20 18 41 72 84 81 65 50 21 -13 -68 90 19 -59 60 -32 73 -44 32 -98 -28 19 61 101 -84 -70 -70 -70 -84 101 61 19 -28 -98 34 -43 75 -28 61 -58 19 89 -70 -16 19 47 61 75 75 61 34 5 -28 -84 61 
89 -70 0 101 19 -12 -37 -17 17 100 -14 114 60 45 41 81 -68 35 -56 102 75 89 -98 -28 60 -16 -84 101 101 -70 -16 75 -16 -70 101 101 -84 -16 61 -28 -98 89 75 101 -58 34 -70 75 34 34 47 101 -28 89 5 -28 -43 -16 19 101 0 -70 89 75 
-58 -16 -70 5 -12 97 113 44 89 48 -78 -82 21 44 -17 41 0 90 102 5 47 -16 61 34 -70 -70 76 -98 75 -70 -70 34 61 0 47 5 101 101 5 34 -16 47 19 -98 -84 47 89 34 -98 101 0 5 -58 0 -43 34 34 -58 -28 -98 -28 -58 34 34 
-70 -70 0 -98 78 97 -33 104 80 107 -6 -78 120 -56 44 -7 -12 34 -58 101 -84 -16 101 76 102 -15 -96 102 -69 35 -28 -28 19 -70 89 101 -43 75 47 75 -58 75 61 101 -16 -84 -84 -28 75 19 34 101 5 -28 0 61 0 -28 5 89 19 19 61 -43 
75 -84 5 -70 -94 -78 -17 89 14 -6 21 69 -39 104 73 82 -66 34 -28 -43 -28 34 -57 91 77 103 -40 63 7 0 20 101 0 -58 -70 -28 47 -43 -98 101 -70 5 -84 89 75 -98 -16 -98 75 75 -98 -16 -98 75 75 -84 0 -84 89 101 -58 19 -43 -84 
5 75 19 38 -62 -86 -14 120 -75 21 0 31 -48 -52 35 -17 13 -66 -84 0 -70 -27 77 64 -95 64 78 -25 -55 0 -82 -69 19 -16 19 -58 -58 19 -28 5 -84 -98 -28 -84 -58 47 19 89 19 34 -84 101 -58 75 75 -43 -84 -43 75 75 -58 101 -84 34 
-58 -84 61 -43 23 69 59 35 -39 56 128 -62 -66 89 6 97 -54 -43 -58 101 6 103 -55 -40 -67 92 0 78 -94 -81 104 36 -69 5 34 34 5 -70 34 101 -70 -84 89 4 -98 -43 -16 -28 -84 47 -70 -16 0 -16 -69 47 -84 -28 -28 -43 101 0 75 -98 
47 47 -58 -43 78 97 17 48 -25 2 -75 -39 107 -70 85 -90 65 -84 75 -70 102 -41 -67 0 -23 66 39 -80 -93 0 0 91 90 -16 0 -98 -84 34 47 -28 -1 -85 -44 100 -71 74 -98 61 -98 61 -84 90 -57 -97 -27 -57 20 0 89 61 -58 -58 34 34 
47 101 47 89 9 27 -74 -74 20 10 80 35 89 17 59 -37 -24 89 75 -43 -69 0 -40 9 -53 -22 108 107 0 0 78 49 -97 61 -98 47 75 -16 -16 88 73 -44 -86 -19 -72 -30 -99 -85 47 47 -69 -82 0 -41 21 -27 7 -68 -42 61 61 -43 -70 5 
-16 34 19 -84 -43 -80 27 59 -4 85 89 17 85 73 -20 23 0 101 -84 90 -26 -13 -80 0 0 -78 -20 -38 80 -93 92 -25 0 -57 34 34 -28 34 33 -59 -3 -31 86 -88 72 -31 -19 -72 4 6 -68 0 -13 104 -67 -96 8 36 -14 76 89 19 89 89 
101 -98 -70 -28 19 101 -24 82 2 -78 85 41 13 13 23 47 89 -58 5 101 6 -82 64 9 -23 -39 -38 -22 0 51 104 -26 76 -28 101 34 -16 -44 -59 -60 -45 -4 30 98 -19 71 -19 -100 46 6 -13 -26 -25 0 23 78 -54 21 -81 35 -42 -98 75 47 
-58 34 89 89 34 -70 0 9 -24 93 -37 -12 -39 93 -28 5 0 -58 34 89 90 49 -55 9 23 0 -92 -11 10 0 -81 7 48 47 -16 89 -70 -59 100 2 71 98 58 -20 58 98 71 2 100 -57 -67 92 -12 51 52 10 -80 0 8 -14 -97 0 19 5 
34 19 -58 19 19 -28 61 101 61 -28 23 19 -58 19 34 0 89 -84 101 19 76 77 8 91 -94 78 -23 9 0 -81 -13 -14 -69 19 47 5 -84 -29 -44 86 -46 -33 -90 0 42 15 -75 -19 -19 -84 0 8 -24 80 -92 94 10 65 78 7 102 -98 89 -16 
75 -70 -43 -28 -28 -70 89 5 -98 -16 47 89 101 89 61 5 -70 47 -84 -16 19 48 36 8 -40 104 9 91 -40 0 20 20 0 -58 89 0 88 -59 -3 17 16 0 -49 95 0 -104 -35 16 59 60 47 8 -53 66 -37 39 94 -94 -80 -96 77 6 -70 34 
19 19 89 5 5 61 -16 -16 34 -43 -58 0 -84 101 -58 75 47 101 5 -16 19 -70 -97 -56 63 36 78 -26 -68 -26 76 34 75 -28 -70 -43 47 4 32 -87 85 -101 -6 -63 -50 40 -7 0 98 45 61 -69 78 93 -38 107 -94 -25 -96 -82 -15 -84 -84 -16 
5 -70 61 -16 -84 47 -16 -70 75 19 -28 -84 89 34 5 -28 -70 -98 89 61 47 34 19 6 0 0 0 6 6 20 34 47 75 89 -98 -58 -28 4 45 86 -74 -19 28 81 -78 -8 55 -91 -6 72 -58 20 -97 -14 79 -24 66 -39 64 -41 76 -28 101 5 
-28 75 -43 34 -98 -43 5 47 89 -98 -84 -84 -98 101 75 34 -16 -70 75 0 -84 19 -84 5 101 -28 35 89 -84 -43 -16 0 0 0 -16 -43 -70 88 32 -19 -100 30 -60 41 -77 13 95 -50 0 59 100 -85 -57 -56 -54 -54 -80 104 64 7 -57 89 5 -84 
101 19 -28 -43 -43 0 61 -43 75 19 5 5 47 -98 0 -98 61 34 34 61 -84 5 -84 75 34 34 75 -84 5 -84 61 19 19 47 101 -28 89 19 -17 -18 -3 44 -88 28 -34 -77 -91 -78 -21 58 -45 88 46 34 48 104 -40 64 -14 -57 -70 -70 -16 47 
75 61 -43 -16 -84 -28 -58 19 19 -70 -28 -84 -16 -43 47 61 -16 19 -28 47 34 -70 -43 89 -70 -98 -16 -16 101 -84 61 -84 101 -16 0 -98 -58 101 -28 -44 60 72 -4 42 0 82 67 -21 0 -62 1 -33 59 73 -17 19 -28 34 6 -98 -84 47 101 47 
-43 -98 101 -58 47 5 5 75 0 -43 -16 61 -16 -43 0 89 19 5 61 -43 -98 -98 -28 89 47 75 -70 61 34 75 -58 89 75 -84 5 -43 -28 19 -70 101 -98 -29 100 71 98 -33 -102 98 -77 15 -34 -33 17 -73 87 100 -44 88 46 75 -58 89 61 101 
47 89 -43 89 34 34 75 -58 75 19 19 75 -58 75 34 34 89 -28 101 61 61 -98 0 -84 101 -98 -43 47 -28 -58 -43 5 -98 47 19 34 101 -16 -84 -98 -84 -16 88 18 2 17 84 -5 -76 -89 -62 0 -89 70 59 86 -59 59 3 -1 34 -98 19 -28 
61 -28 -43 19 -28 -16 89 75 -84 61 75 -43 -84 -28 101 101 -16 -70 -28 89 89 -43 -98 -70 34 19 89 19 34 -70 -98 -43 101 101 -16 -43 0 -84 -84 0 -58 -16 100 87 -45 99 -88 30 1 69 0 15 -103 83 -77 58 70 -60 -100 -59 73 75 -58 101 
-16 19 19 -16 -84 19 89 -98 -98 75 0 89 -58 -28 -43 -84 34 -84 -28 0 -28 -84 34 -84 -43 -28 -58 101 5 75 -84 -84 101 34 -70 0 34 34 0 -84 19 89 -98 100 60 -19 72 -87 -60 -75 83 -7 82 -77 -63 -77 68 -20 58 -100 -100 88 19 -70 
-28 -28 89 101 5 19 -70 -43 89 -84 47 89 19 61 5 61 5 61 19 75 34 -98 75 -58 -84 0 -16 75 61 -58 -58 34 47 -58 -58 61 75 0 5 -70 -43 89 -84 61 100 32 87 19 71 31 84 42 -103 67 -64 -91 -8 -36 57 30 -88 -86 4 5 
-28 19 -28 0 -84 -70 47 34 -84 101 -28 -84 -28 -98 -70 61 75 -28 -43 47 19 89 34 89 19 47 -43 -28 75 61 -70 -98 -43 -98 -43 89 -98 19 34 -84 -98 -16 -43 5 -43 -1 -85 -59 59 59 -60 -77 0 -38 11 -39 0 -79 -63 56 58 -60 -86 -1 
47 -98 101 5 61 19 -84 -43 -98 0 5 -58 5 5 -70 -16 -28 75 -98 89 -28 0 -58 19 19 -43 19 5 -70 -16 -43 61 89 47 -70 -58 101 -43 -43 89 -58 -70 47 89 47 -58 -28 -84 3 3 -59 16 0 -78 -24 -52 53 95 55 -62 -33 -100 -18 -1 
-58 -70 -70 -43 -16 34 101 -16 75 -16 -98 61 5 -16 -28 -28 0 34 89 -58 34 -70 47 -28 -84 89 61 47 61 89 -84 -28 47 -70 34 -58 89 19 0 -28 -28 -28 0 47 101 -28 61 -28 88 19 -31 -60 -90 -91 -79 -38 0 66 -64 28 -60 72 3 -44 
75 34 -70 0 19 -16 -98 -16 5 -16 -84 5 47 34 -16 89 -70 -58 101 5 89 101 75 0 75 101 89 19 -98 -43 -58 101 0 61 75 19 -58 5 34 5 -70 5 47 34 -28 75 -98 -98 60 -30 31 43 0 -91 -10 11 -11 -93 0 40 28 -19 72 -86 
19 19 -43 34 47 5 -98 -58 -84 47 -98 -98 61 -70 -43 -84 34 89 61 0 61 75 19 -98 -70 -98 19 75 61 0 75 89 47 -70 -28 -58 75 -84 -84 75 -58 -28 -70 34 75 61 -16 47 47 -1 87 -100 84 -20 27 13 -51 11 27 -6 85 -87 100 4 
34 61 61 34 0 -70 47 -58 19 75 101 101 89 47 -16 -98 0 75 -70 -43 -28 -43 -84 61 -16 89 -43 19 61 75 61 19 -28 101 0 89 -58 -28 0 -16 -43 -98 34 -58 19 89 -70 -58 -58 -84 74 -3 -100 -5 56 -103 -77 -78 -102 58 -4 -100 -2 74 
61 -58 101 -98 0 -58 -28 47 0 5 89 34 47 -84 61 75 -70 75 89 -58 89 89 -43 89 89 -58 75 75 -70 61 47 -98 19 5 75 -16 -28 19 -70 -84 -28 89 61 -98 19 0 34 -70 -98 -58 61 19 59 -46 -89 -47 58 15 44 -60 99 -87 19 -29 
47 101 -58 0 61 -84 -16 47 -84 -16 61 -58 19 -98 0 101 -16 89 -16 89 0 -98 19 -70 61 -16 -98 34 -28 -98 47 -16 -70 75 19 -16 -70 101 61 34 0 -28 -58 -84 -98 101 89 75 75 75 75 75 88 100 -100 -87 -59 -46 -19 18 44 87 -85 -28 
89 0 -98 5 101 -16 61 -84 -28 5 47 75 89 101 101 89 61 19 -16 -70 75 5 -70 47 -58 34 -84 0 61 -84 -28 5 34 47 61 61 47 34 5 -28 -84 61 0 -84 34 -58 47 -70 5 75 -70 -16 19 60 87 100 100 86 73 45 3 -29 -84 61 
-70 -16 75 -16 -84 101 89 -98 -28 47 -43 101 61 61 75 -84 5 -98 47 5 0 19 61 -70 47 -28 -70 -84 -70 -16 47 -58 89 34 19 34 75 -58 34 -43 -84 101 -98 -58 5 -98 19 -28 -43 -43 0 61 -58 75 4 -17 -1 19 88 -29 88 34 0 0 
