-112 -112 -108 -111 -111 -117 -124 -125 -125 -126 -128 -128 -128 -112 -128 -128 
-112 -108 -101 -107 -111 -117 -123 -110 -110 -126 -128 -112 -112 -93 -112 -112 
-108 -101 -96 -100 -101 -108 -101 -83 -80 -108 -107 -92 -93 -71 -93 -93 
-111 -107 -96 -99 -99 -102 -100 -89 -84 -101 -81 -68 -64 -48 -71 -81 
-111 -108 -94 -95 -83 -80 -76 -72 -67 -65 -48 -41 -32 -13 -48 -71 
-115 -112 -96 -92 -70 -72 -57 -48 -47 -30 -32 -20 -12 -4 -40 -64 
-118 -108 -89 -80 -49 -33 -12 4 9 24 18 26 2 8 -37 -65 
-121 -111 -94 -77 -48 -31 -2 30 35 63 43 48 13 20 -39 -62 
-121 -112 -96 -78 -51 -32 6 42 58 96 71 74 36 29 -36 -57 
-115 -111 -93 -72 -47 -24 19 62 103 128 112 95 62 41 -20 -54 
-121 -115 -105 -96 -72 -58 -7 19 54 90 86 71 46 21 -26 -56 
-119 -113 -105 -100 -85 -73 -23 2 27 68 50 44 19 3 -33 -64 
-119 -116 -108 -108 -100 -87 -56 -20 -2 16 1 1 -28 -34 -72 -87 
-117 -114 -111 -112 -103 -102 -83 -58 -47 -24 -51 -48 -73 -79 -96 -96 
-121 -117 -114 -116 -117 -113 -100 -84 -78 -65 -93 -91 -109 -96 -115 -115 
-121 -121 -117 -120 -119 -113 -109 -102 -94 -93 -102 -110 -128 -115 -128 -128 
