-55 -55 -18 -53 -51 -88 -122 -123 -123 -126 -128 -128 -128 -122 -128 -128 
-54 -18 14 -16 -50 -85 -119 -37 -39 -125 -128 -122 -122 -110 -122 -122 
-18 14 53 18 -6 -40 7 128 128 -39 -103 -104 -110 -98 -110 -110 
-53 -16 26 -2 -21 -52 -73 -6 3 -87 -72 -76 -76 -80 -98 -104 
-50 -43 10 -13 11 -19 -35 -34 -23 -25 -26 -32 -36 -41 -80 -98 
-82 -76 -23 -39 -1 -21 12 8 8 29 18 15 -8 -29 -75 -98 
-113 -97 -34 -40 11 33 91 105 111 115 94 79 33 -1 -53 -93 
-116 -106 -86 -45 5 39 90 95 100 102 63 40 -6 -43 -97 -110 
-120 -109 -81 -48 -3 33 88 95 104 89 38 -8 -42 -69 -116 -122 
-115 -112 -72 -53 -10 20 74 65 70 53 14 -37 -70 -104 -128 -128 
-106 -100 -78 -69 -36 -35 7 3 -3 -16 -50 -80 -110 -128 -128 -128 
-96 -86 -64 -60 -38 -44 -24 -30 -38 -41 -85 -94 -116 -128 -128 -128 
-95 -76 -57 -62 -57 -66 -59 -69 -74 -78 -106 -112 -128 -128 -128 -128 
-89 -70 -52 -58 -63 -74 -71 -91 -98 -94 -112 -118 -124 -128 -128 -128 
-100 -88 -70 -79 -86 -96 -106 -106 -106 -112 -118 -124 -128 -128 -128 -128 
-104 -102 -89 -98 -96 -105 -113 -114 -112 -116 -118 -124 -128 -128 -128 -128 
