24 24 24 24 24 24 24 24 24 24 24 24 24 24 24 24 25 25 25 25 25 25 25 25 25 25 25 25 25 25 25 25 25 25 25 25 25 25 25 25 25 25 25 25 25 25 25 25 25 25 25 25 25 26 25 25 25 25 25 25 25 25 25 25 
24 24 24 24 24 24 24 24 24 24 23 24 24 24 24 24 25 25 25 25 25 25 25 25 25 25 25 25 25 25 25 25 25 25 25 25 25 25 25 25 25 25 25 25 25 25 25 25 25 26 26 26 26 30 26 26 26 26 25 25 25 25 25 25 
24 24 24 24 24 24 23 23 23 23 21 23 23 23 23 24 25 25 25 25 25 25 25 25 25 25 25 25 25 25 25 25 25 25 25 25 25 25 25 25 25 25 25 25 25 25 25 25 26 26 30 30 30 35 30 30 30 26 26 25 25 25 25 25 
24 24 24 24 24 23 23 21 21 21 18 21 21 21 23 23 25 25 25 25 25 25 25 25 25 25 25 25 25 25 25 25 25 25 25 25 25 25 25 25 25 25 25 25 25 25 25 26 30 30 35 35 35 38 35 35 35 30 30 26 25 25 25 25 
24 24 24 24 23 21 21 18 18 18 17 18 18 18 21 21 21 25 25 25 25 25 25 25 25 25 25 25 25 25 25 25 25 25 25 25 25 25 25 25 25 25 25 25 25 25 26 30 30 35 38 38 38 46 38 38 38 35 30 30 26 25 25 25 
24 24 24 23 21 21 18 17 16 16 16 16 16 16 18 21 18 21 25 25 25 25 25 25 25 25 25 25 25 25 25 25 25 25 25 25 25 25 25 25 25 25 25 25 25 26 26 30 35 38 46 46 46 53 46 46 46 38 35 30 26 26 25 25 
24 24 23 23 21 18 17 16 16 16 14 15 16 16 16 18 18 21 22 25 25 25 25 25 25 25 25 25 25 25 25 25 25 25 25 25 25 25 25 25 25 25 25 25 25 26 30 35 38 46 46 53 53 59 63 53 46 46 38 35 30 26 25 25 
24 24 23 21 18 17 16 16 14 14 12 14 14 15 15 16 15 18 23 25 25 25 25 25 25 25 25 25 25 25 25 25 25 25 25 25 25 25 25 25 25 25 25 25 25 26 30 35 38 46 63 69 69 74 80 69 63 54 47 35 30 26 25 25 
24 24 23 21 18 16 16 14 12 11 11 11 11 14 15 16 14 18 22 25 25 25 25 25 25 25 25 25 25 25 25 25 25 25 25 25 25 25 25 25 25 25 25 25 25 26 30 35 38 54 63 80 81 91 94 80 70 64 47 43 30 26 25 25 
24 24 23 21 18 16 16 14 11 10 9 9 11 14 15 16 12 18 21 25 25 25 25 25 26 26 26 25 25 25 25 25 25 25 25 25 25 25 25 25 25 25 25 25 26 30 35 38 54 70 80 94 97 112 110 94 86 81 64 58 43 30 26 25 
24 23 21 18 17 16 14 12 11 9 7 9 9 11 14 15 14 17 19 23 25 25 25 25 26 26 26 25 25 25 25 25 25 25 25 25 25 25 25 25 25 25 25 25 25 26 30 43 58 64 81 96 101 110 113 96 90 83 66 54 47 34 25 25 
24 24 23 21 18 16 15 14 11 9 9 9 11 14 14 16 14 18 21 24 25 25 25 25 26 26 26 25 25 25 25 25 25 25 25 25 25 25 25 25 25 25 25 25 25 26 39 43 58 73 90 104 104 113 114 104 98 92 74 63 47 34 33 25 
24 24 23 21 18 16 16 14 11 11 9 11 11 14 14 16 14 18 21 24 25 25 25 25 25 25 25 25 25 25 25 25 25 25 25 25 25 25 25 25 25 25 25 25 25 26 39 54 66 83 92 98 107 115 116 107 102 92 84 72 58 44 33 25 
24 24 23 21 18 16 16 15 14 14 11 14 14 14 14 16 16 18 21 23 25 25 25 25 25 25 25 25 25 25 25 25 25 25 25 25 25 25 25 25 25 25 25 25 25 26 34 47 63 74 92 102 109 116 119 109 109 93 81 69 53 44 33 25 
24 24 23 23 21 18 16 15 15 15 14 14 14 14 16 17 18 19 19 23 24 24 25 25 25 25 25 25 25 25 25 25 25 25 25 25 25 25 25 25 25 25 25 25 25 25 34 47 58 72 84 93 104 119 121 113 104 90 77 69 53 41 33 25 
24 24 24 23 21 21 18 16 16 16 15 16 16 16 17 18 18 19 23 21 23 23 23 23 22 24 25 25 25 25 25 25 25 25 25 25 25 25 25 25 25 25 25 25 25 33 41 53 69 77 90 99 109 122 128 118 109 94 85 73 58 49 41 33 
25 25 25 25 21 18 18 16 15 14 14 14 14 16 18 18 19 21 21 21 21 21 21 21 21 21 22 23 23 25 25 25 25 25 25 25 25 25 25 25 25 25 25 25 25 25 33 41 53 63 77 86 94 109 115 105 94 82 73 58 49 41 33 25 
25 25 25 25 25 22 21 19 18 18 17 18 18 18 19 19 21 21 21 20 19 18 18 18 18 19 17 21 22 23 25 25 25 25 25 25 28 25 25 25 25 25 25 25 25 25 33 41 49 63 73 82 91 94 100 91 91 82 68 58 49 41 33 25 
25 25 25 25 25 25 25 25 24 21 22 23 23 21 21 23 21 21 20 17 17 16 14 14 14 14 12 15 17 18 18 25 27 27 28 28 31 28 28 28 28 25 25 25 25 25 33 41 49 58 68 68 77 82 85 77 77 68 68 58 49 41 33 25 
25 25 25 25 25 25 25 25 25 25 24 25 25 24 23 21 21 20 17 16 16 12 11 7 7 8 5 11 12 14 18 23 27 31 31 31 35 31 31 31 28 28 25 25 25 25 33 33 41 49 58 68 69 69 77 69 69 69 58 49 41 33 33 25 
25 25 25 25 25 25 25 25 25 25 25 25 25 25 24 23 21 19 17 16 11 5 5 3 2 4 2 4 6 10 18 23 27 35 35 35 38 35 35 35 31 31 28 25 25 25 25 33 41 41 49 58 59 59 69 59 59 59 49 41 41 33 25 25 
25 25 25 25 25 25 25 25 26 26 25 25 25 25 25 23 21 18 16 12 5 5 0 0 0 0 0 1 3 6 15 22 27 34 38 38 40 38 38 38 35 31 31 28 25 25 25 25 33 41 41 49 49 49 59 49 49 49 42 41 33 25 25 25 
25 25 25 25 25 25 25 26 26 26 26 25 25 25 24 23 21 18 14 11 5 0 0 -6 -6 -3 -8 -1 0 2 11 18 28 36 36 40 43 40 40 40 38 35 31 28 28 25 25 25 25 33 34 42 42 42 50 42 42 42 34 34 25 25 25 25 
25 25 25 25 25 25 25 25 26 26 25 25 25 25 24 23 21 18 14 7 3 0 -6 -10 -12 -11 -11 -11 -1 3 5 16 26 31 39 43 46 43 44 40 40 38 35 31 28 25 25 25 25 25 34 34 34 34 42 34 34 34 34 25 25 25 25 25 
25 25 25 25 25 25 25 25 25 25 25 25 25 25 25 22 21 18 14 7 3 0 -6 -12 -23 -22 -23 -14 -11 0 3 12 22 23 39 45 48 46 46 43 40 38 35 31 28 25 25 25 25 25 25 25 25 25 34 25 25 25 25 25 25 25 25 25 
25 25 25 25 25 25 25 25 25 25 25 25 25 25 25 23 21 18 14 8 4 0 -3 -11 -23 -26 -28 -23 -14 -11 -3 4 12 14 31 38 46 44 47 44 40 38 35 31 28 25 25 25 25 25 25 25 25 25 29 25 25 25 25 25 25 25 25 25 
25 25 25 25 25 25 25 25 25 25 25 25 25 25 25 23 22 17 12 6 1 0 -8 -11 -23 -28 -32 -27 -27 -14 -12 -3 3 5 18 31 40 46 48 48 44 40 38 35 31 27 25 25 25 25 27 27 29 27 32 29 27 27 27 25 25 25 25 25 
25 25 25 25 25 25 25 25 25 25 25 25 25 25 25 23 23 21 15 11 4 1 -2 -11 -14 -23 -30 -34 -37 -27 -25 -13 -3 0 17 23 28 38 46 43 46 42 40 31 28 25 25 25 25 27 27 30 30 30 35 30 30 30 27 27 25 25 25 25 
25 25 25 25 25 25 25 25 25 25 25 25 25 25 25 25 23 22 17 12 6 2 0 -8 -15 -20 -34 -40 -38 -39 -36 -25 -22 -9 5 17 18 24 47 39 41 48 40 37 27 25 25 25 27 30 30 35 35 35 36 35 35 35 30 30 27 25 25 25 
25 25 25 25 25 25 25 25 25 25 25 25 25 25 25 25 25 23 22 14 9 3 0 0 -9 -20 -28 -36 -44 -44 -46 -42 -23 -24 -6 6 7 12 34 34 45 41 46 41 37 25 25 27 29 30 34 36 36 36 40 36 36 36 34 30 30 27 25 25 
25 25 25 25 25 25 25 25 25 25 25 25 25 25 27 27 27 27 24 22 17 11 4 0 -2 -14 -30 -37 -45 -54 -52 -48 -37 -34 -22 -5 2 3 22 20 39 44 43 41 45 33 30 30 34 34 36 39 40 39 44 40 39 39 36 34 29 27 27 25 
25 25 25 25 25 25 25 25 25 25 25 25 25 27 27 29 29 29 34 24 22 22 11 6 0 -9 -23 -31 -41 -52 -53 -60 -53 -47 -28 -21 -9 -5 14 18 31 44 44 42 45 37 39 38 37 39 39 39 44 44 46 44 44 39 39 36 34 29 27 25 
25 25 25 25 25 25 25 25 25 25 25 25 27 29 29 34 34 34 36 34 28 24 21 13 8 0 -17 -25 -41 -47 -54 -59 -61 -58 -45 -30 -18 -9 11 12 26 38 46 43 44 45 42 39 39 43 43 43 46 46 48 46 46 43 39 36 34 29 27 25 
25 25 25 25 25 25 25 25 25 25 25 27 30 30 34 36 36 36 39 36 36 33 28 19 10 0 -16 -22 -38 -57 -58 -67 -69 -69 -66 -42 -30 -19 5 8 18 29 32 43 45 41 46 43 44 43 46 46 46 48 54 48 46 43 39 36 34 29 27 25 
25 25 25 25 25 25 25 25 25 25 27 27 30 34 36 39 39 40 44 40 40 40 32 28 20 9 0 -11 -24 -42 -54 -55 -64 -76 -60 -49 -31 -18 5 9 24 29 36 38 45 45 47 49 49 49 48 48 53 54 56 54 48 46 43 39 36 34 29 27 
25 25 25 25 25 25 25 25 25 25 27 30 34 36 39 40 44 44 46 44 44 40 41 36 29 16 0 -2 -17 -27 -36 -50 -50 -58 -54 -52 -38 -20 6 11 23 33 42 44 53 50 54 47 49 49 49 48 48 48 54 48 46 43 39 36 34 29 27 25 
25 25 25 25 25 25 25 25 25 25 27 30 35 36 40 44 46 46 51 46 46 44 41 38 30 19 8 -2 -19 -34 -36 -46 -49 -59 -54 -59 -46 -34 -5 2 11 21 36 35 42 43 48 46 49 49 49 48 48 46 48 46 46 43 39 36 34 29 27 25 
25 25 25 25 25 25 25 25 25 25 27 30 35 36 41 44 46 51 54 52 48 46 42 39 35 22 15 6 -4 -22 -31 -34 -37 -46 -41 -44 -43 -33 -6 1 17 19 34 39 46 46 46 46 49 49 49 46 46 44 46 44 43 39 39 36 34 29 27 25 
25 25 25 25 25 25 25 25 25 27 30 35 36 40 44 46 51 54 59 56 52 48 46 42 39 35 23 11 3 -7 -17 -21 -23 -33 -30 -31 -31 -19 0 0 12 25 38 44 52 52 51 45 48 49 49 49 46 44 47 39 39 39 36 34 29 27 27 25 
25 25 25 25 25 25 25 25 25 25 27 30 35 36 41 44 46 52 56 52 48 46 42 39 35 33 29 16 5 0 -9 -16 -21 -24 -23 -22 -23 -16 -5 -1 9 20 26 33 39 41 44 39 41 42 46 47 44 42 47 42 42 41 37 29 29 27 25 25 
25 25 25 25 25 25 25 25 25 25 27 30 35 36 41 44 46 46 52 48 48 46 42 39 35 33 29 26 14 11 0 0 -7 -21 -10 -11 -13 -5 2 2 11 19 24 31 38 39 39 39 40 39 43 48 44 41 52 41 41 41 35 35 27 25 25 25 
25 25 25 25 25 25 25 25 25 25 27 30 34 36 40 41 44 46 48 46 46 42 42 39 35 33 29 26 26 11 10 1 0 -7 -5 0 -6 -6 8 4 11 18 20 29 35 23 30 29 37 35 38 44 41 38 54 45 45 44 35 35 29 25 25 25 
25 25 25 25 25 25 25 25 25 25 27 27 30 35 36 41 41 41 46 42 42 42 39 35 33 29 29 25 26 26 17 11 8 0 1 2 2 0 8 4 11 17 20 23 22 23 17 28 32 25 34 34 37 40 50 46 46 46 40 32 32 29 25 25 
25 25 25 25 25 25 25 25 25 25 25 29 32 32 35 38 38 39 41 39 39 39 35 33 33 29 25 25 25 25 26 15 13 7 7 3 1 2 13 4 11 17 19 13 16 13 16 16 24 19 28 30 28 36 45 42 50 50 44 37 32 29 29 25 
25 25 25 25 25 25 25 25 25 26 25 25 29 33 32 35 35 35 39 35 35 35 33 33 29 25 25 25 25 25 25 25 15 14 11 8 1 0 14 6 8 18 10 9 16 6 6 15 19 18 24 22 27 34 47 43 48 50 50 44 37 32 29 25 
25 25 25 25 25 25 25 26 26 26 26 26 26 29 29 33 33 33 35 33 32 32 29 29 25 25 25 25 25 25 25 25 25 21 23 18 11 11 14 14 16 11 13 9 6 0 3 7 7 9 14 21 27 33 31 47 56 48 50 44 37 32 29 25 
25 25 25 25 25 25 26 26 26 26 26 26 26 26 29 29 29 29 33 29 29 29 29 25 25 25 25 25 25 25 31 31 31 31 34 29 26 24 26 17 23 15 6 3 1 -2 0 0 2 0 -1 1 11 17 13 31 33 33 34 44 37 32 29 25 
25 25 25 25 26 26 26 26 26 29 29 28 28 27 26 26 26 26 29 26 25 25 25 25 25 25 25 25 25 31 31 36 36 40 46 37 37 34 29 26 23 15 8 0 0 -1 -1 -3 0 -8 -2 -6 0 7 4 21 21 23 39 34 44 37 32 29 
25 25 25 26 26 26 27 29 29 33 32 32 33 31 27 26 26 26 26 26 26 25 25 25 25 25 25 25 31 36 38 43 46 49 53 48 48 45 40 34 31 19 12 3 0 -3 -4 -6 -22 -38 -23 -25 -13 -5 -6 0 2 4 21 15 25 32 29 25 
25 25 25 26 26 26 29 32 33 35 35 35 35 34 31 28 26 26 26 26 26 25 25 25 25 25 25 31 36 37 46 52 56 58 62 57 58 54 46 41 31 22 7 0 -3 -9 -9 -28 -44 -44 -46 -49 -36 -31 -34 -15 -8 -8 0 14 11 20 29 25 
25 25 26 26 26 29 29 33 34 35 35 35 35 35 34 31 27 26 26 26 25 25 25 25 25 25 31 31 37 46 55 62 65 68 71 67 68 63 56 46 39 26 20 6 0 -3 -19 -20 -35 -52 -57 -65 -53 -46 -47 -32 -26 -24 -2 1 11 19 14 25 
25 25 26 26 26 29 33 35 35 39 37 39 37 36 35 33 27 26 26 26 26 26 25 25 25 25 31 36 46 54 62 67 73 75 79 75 74 68 65 56 46 32 22 7 0 -3 -19 -41 -50 -68 -72 -65 -76 -69 -71 -54 -46 -25 -25 -15 -5 0 13 23 
25 25 26 26 26 29 33 35 36 39 39 37 37 35 34 32 27 26 26 26 25 25 25 25 25 25 31 38 46 56 65 74 79 82 86 82 80 75 65 56 46 34 22 7 0 -3 -18 -34 -46 -66 -69 -83 -90 -90 -92 -77 -71 -46 -32 -22 -6 0 8 23 
25 26 26 26 27 32 34 35 39 45 43 39 37 36 35 33 29 26 26 26 25 25 25 25 25 25 31 38 46 57 65 75 81 90 94 89 81 75 67 57 48 34 26 14 7 0 -18 -34 -45 -59 -72 -82 -97 -106 -109 -93 -71 -55 -38 -22 -12 -2 7 23 
25 25 26 26 26 29 33 35 36 39 38 37 35 35 33 29 26 26 26 26 26 25 25 25 25 31 36 46 54 63 74 80 89 99 104 96 89 80 74 64 56 46 31 21 12 -2 -25 -44 -60 -75 -85 -96 -112 -123 -128 -116 -93 -71 -60 -44 -34 -17 -2 7 
25 25 26 26 26 29 32 34 35 36 35 35 35 35 32 29 26 26 26 25 25 25 25 25 25 25 31 38 46 56 65 74 81 90 93 87 80 74 65 56 46 39 31 22 12 12 -2 -19 -36 -60 -63 -80 -96 -106 -116 -100 -79 -61 -45 -34 -18 -2 7 23 
25 25 26 26 26 27 29 33 33 35 35 34 33 33 31 27 26 26 25 25 25 25 25 25 25 25 31 38 46 56 65 74 80 81 86 81 80 72 64 56 46 39 31 25 19 17 0 -13 -29 -53 -63 -80 -95 -88 -100 -83 -83 -69 -52 -34 -20 -3 7 22 
25 25 25 26 26 26 27 29 29 33 32 32 32 31 26 26 26 26 25 25 25 25 25 25 25 25 31 38 46 54 62 65 72 75 79 74 72 65 62 55 46 36 31 25 25 17 3 -6 -22 -45 -58 -58 -72 -73 -83 -69 -69 -52 -52 -34 -19 -2 7 22 
25 25 25 26 26 26 26 26 26 29 27 27 27 26 26 26 26 25 25 25 25 25 25 25 25 25 31 31 38 46 56 62 62 66 69 64 65 62 53 45 36 31 31 25 25 25 10 10 0 -22 -34 -49 -50 -51 -68 -52 -52 -52 -34 -20 -3 7 7 23 
25 25 25 25 26 26 26 26 26 26 26 26 26 26 26 26 25 25 25 25 25 25 25 25 25 25 25 31 36 38 46 53 53 56 59 54 54 50 43 37 36 31 25 25 25 25 25 10 0 0 -16 -34 -34 -34 -51 -34 -34 -34 -20 -3 -3 7 22 23 
25 25 25 25 25 25 26 26 26 26 26 26 26 26 25 25 25 25 25 25 25 25 25 25 25 25 25 25 31 36 38 43 43 46 49 45 46 42 36 36 31 25 25 25 25 25 25 25 10 0 0 -16 -17 -18 -34 -18 -20 -19 -3 -3 7 21 22 23 
25 25 25 25 25 25 25 25 25 26 25 25 25 25 25 25 25 25 25 25 25 25 25 25 25 25 25 25 25 31 31 36 36 38 42 36 36 36 31 31 25 25 25 25 25 25 25 25 25 8 8 0 -1 -2 -17 -2 -3 -2 7 7 21 22 23 23 
25 25 25 25 25 25 25 25 25 25 25 25 25 25 25 25 25 25 25 25 25 25 25 25 25 25 25 25 25 25 31 31 31 31 36 31 31 31 29 25 25 25 25 25 25 25 25 25 25 25 8 8 8 7 -2 7 7 7 7 22 22 23 23 23 
25 25 25 25 25 25 25 25 25 25 25 25 25 25 25 25 25 25 25 25 25 25 25 25 25 25 25 25 25 25 25 25 25 25 29 25 25 25 25 25 25 25 25 25 25 25 25 25 25 25 25 23 23 23 7 23 22 22 23 23 23 23 23 24 
