1 -5 -5 5 -8 5 -2 4 7 -7 -6 -4 0 6 0 -2 
-5 -2 -6 -4 2 7 -6 -8 -4 5 -1 7 -5 7 -8 -5 
6 3 5 3 -8 -4 -7 6 -2 -7 0 -4 7 -8 -6 6 
-4 4 0 4 6 -6 5 -3 6 6 1 -4 -3 -8 2 1 
-7 -1 -5 -2 -8 -4 -7 1 5 5 4 1 -2 -4 -4 -2 
4 4 3 -3 0 -8 3 -3 4 4 -5 6 1 -7 -4 7 
-2 6 3 -3 -2 -2 7 1 6 -2 3 -3 5 5 6 -1 
6 1 -2 3 5 -8 2 -8 -2 -6 1 7 2 6 -7 0 
-6 -4 7 -5 -6 3 -8 -6 -5 -6 -6 -6 -3 3 -3 -4 
-8 6 -5 5 1 -4 2 2 7 -2 6 -6 -8 -3 6 -1 
1 5 2 1 -6 -8 1 1 -1 5 -5 -4 -1 -3 1 2 
-7 4 5 2 -2 -1 -6 4 1 -8 -4 4 3 -1 -3 2 
-7 -2 1 4 6 -6 1 -5 -7 -4 6 7 0 3 0 -8 
3 -1 0 3 5 3 -6 7 7 7 4 -5 -7 -5 -2 -1 
1 -1 -3 6 1 -7 5 -1 1 2 -4 -8 -1 -6 2 0 
3 6 7 -6 4 -6 1 -2 7 -1 -3 5 -4 7 -4 -2 
