16 -89 90 2 29 -25 29 0 79 90 2 40 0 54 40 -53 -39 79 -77 79 -39 -53 54 79 16 66 29 -77 -77 29 66 16 79 54 -53 -39 79 -77 79 -39 -53 40 66 0 40 16 90 90 2 29 -15 29 2 -89 -89 29 66 16 90 66 -25 0 -77 -25 
-53 29 -39 -53 -15 66 16 2 54 -39 -77 -63 0 -89 66 90 -25 90 79 -89 0 -53 -63 -15 79 29 40 90 2 -25 0 66 0 -25 0 79 16 2 54 -53 90 -89 -39 66 29 40 -77 29 2 29 -77 54 40 79 -25 -77 -77 -25 79 29 40 -77 29 2 
79 -89 -15 90 40 29 66 -53 54 0 2 29 -89 29 -15 -15 16 -89 16 -15 -15 16 -89 29 0 0 40 -63 54 16 29 66 -25 90 54 66 -77 16 -53 -77 -63 0 79 16 0 2 66 -25 -89 79 -89 -25 66 2 0 2 66 -15 -77 -89 -63 2 -89 54 
-39 79 79 -25 -77 -25 74 60 -58 80 -82 23 12 79 16 29 -63 -89 -39 90 -89 0 -39 0 -77 -77 2 -39 0 -89 90 -25 -89 -63 40 16 79 16 29 -63 90 -53 79 80 -25 -63 -25 90 90 -25 -77 -53 54 40 -89 54 79 -15 -39 2 -53 -39 40 16 
-77 -89 66 -15 66 -81 -75 -99 43 -42 29 79 79 59 16 -77 0 29 29 0 -63 29 90 -63 -76 80 17 -87 -24 0 -14 -63 54 -53 0 16 2 -53 66 -53 0 3 -14 -75 30 -88 -52 -39 -63 66 -25 29 66 66 29 -25 54 -77 -53 -53 -89 29 -77 -25 
54 2 54 16 74 30 -104 62 -68 -85 -9 -19 48 54 -45 -39 40 54 -39 -39 66 79 2 17 -50 -23 -85 -60 69 -86 56 91 40 90 54 -89 66 -63 -89 -24 -51 17 4 80 68 -38 -38 41 40 -53 -39 54 66 -15 0 -77 -53 66 90 29 66 2 40 0 
-15 -15 79 60 -50 -94 -31 -86 -38 -117 -87 31 37 -58 -76 11 -15 40 0 29 -39 -15 92 94 -10 -21 45 8 59 7 44 -23 0 90 90 -15 -25 29 0 42 0 18 -50 -21 69 69 -37 -61 0 -39 2 -53 -25 90 -89 2 0 79 54 -77 66 -77 54 79 
79 66 -15 23 -4 -105 -86 51 -55 -48 -94 -30 -24 -95 -39 -45 53 90 66 -39 -15 -61 6 19 -36 20 10 -71 -20 -46 59 81 42 -62 -53 90 -39 -24 92 -50 -60 44 81 59 -36 -11 -60 18 17 -39 29 16 -53 0 -25 79 -77 79 -25 -15 -63 2 2 -53 
-63 -63 -53 -31 5 62 -62 13 -73 39 -16 -56 -77 -82 -77 -45 -16 29 90 -15 67 -12 -85 59 21 -6 -6 -5 11 47 97 -36 43 -52 54 -15 -63 91 68 69 69 95 -60 0 59 -48 45 -22 -87 41 16 0 0 2 29 66 -63 2 90 0 -77 54 2 -25 
-89 16 85 -98 63 -4 61 -98 -118 8 -80 -37 -21 -62 37 -89 -70 90 16 90 -76 93 19 -83 -44 -56 87 -4 37 35 -8 95 -37 -24 -53 66 -53 -24 -51 80 -21 7 8 -34 59 -83 -83 69 -12 42 66 40 -25 40 66 54 0 79 -63 -63 79 -15 29 40 
16 -63 0 -6 -76 -9 -6 -44 42 -118 -127 -1 65 72 16 -84 -54 -89 16 54 42 -11 45 59 12 100 -54 102 14 74 59 0 69 80 29 -63 -24 -51 69 -60 -60 71 -45 -18 -57 35 85 71 0 58 56 2 90 -77 90 0 40 40 -25 40 54 2 -89 -63 
-77 -15 16 36 30 12 -38 -105 0 -112 -32 11 41 46 29 -1 -53 66 -39 29 80 -86 -72 -82 74 14 -66 27 100 -32 -7 0 -11 -51 90 16 -77 0 42 80 94 96 60 12 -57 35 -71 -9 19 33 17 0 -53 79 -15 66 -63 -25 0 0 -25 -77 54 -39 
-77 79 -77 0 -38 -19 73 18 41 -68 -102 -88 -2 -43 -14 59 16 29 -77 54 67 -50 95 97 -19 -80 -68 -4 -69 -70 0 -73 -74 -14 -89 -89 -25 91 80 -50 70 59 -82 36 22 73 -6 -19 19 -60 -86 -38 67 40 80 0 -25 2 -89 79 -77 16 -15 16 
40 66 90 -77 -58 -25 -1 37 73 -76 -21 23 73 -52 9 78 -39 16 90 -25 55 -60 19 -83 10 98 0 99 11 -82 19 -60 57 -24 90 29 -39 91 17 -22 -85 59 9 -33 -81 73 36 0 -35 -60 -86 80 56 41 30 17 3 3 2 2 2 16 29 40 
16 16 16 0 -25 -70 66 17 -39 73 -5 -90 3 -96 -17 39 -89 -39 2 29 55 68 69 70 59 34 0 -34 -83 45 -21 94 0 90 0 66 -53 2 55 -87 -49 -20 -9 0 0 -6 -32 -58 83 33 -11 -85 31 -51 43 -51 30 -87 -24 29 79 -77 -53 -25 
40 54 90 -39 54 -25 -82 -95 -95 -62 -1 -95 10 -27 -53 -53 -15 40 -63 40 0 -39 -39 0 44 -60 45 -9 -36 -36 -11 30 -77 29 -25 -63 -77 -53 0 80 -11 -73 83 72 98 -44 23 -71 59 19 8 19 59 -60 32 -22 -74 -86 -75 -39 29 -63 54 2 
-53 66 -77 79 -39 -39 66 89 28 85 64 -39 -39 78 -89 54 -63 -89 2 16 -39 0 -39 29 17 -61 -36 94 -50 -74 0 2 -77 -53 90 -39 -53 29 40 -25 4 -22 44 34 -59 -35 98 -47 -83 0 -9 95 -60 69 -60 -85 6 5 -60 -23 -76 0 -15 79 
-15 90 66 90 -25 90 79 -89 0 -53 -64 -15 79 29 40 -89 16 -15 1 64 -1 -17 0 89 26 16 67 -24 -76 -76 -25 79 40 66 -63 54 29 54 -53 79 67 -87 0 -48 -48 0 -83 70 83 -47 71 34 59 -48 71 59 95 -11 -60 -61 -14 79 40 40 
40 -39 -77 -89 -53 29 -53 -89 90 -53 16 -53 -89 -89 -53 29 -39 -78 -78 -28 52 -18 -56 -42 0 87 15 -2 2 54 -53 79 54 66 -77 16 -39 -63 -53 2 -88 42 32 43 -85 6 -36 -60 -36 19 -59 71 59 83 -35 59 7 0 31 92 3 -39 -39 -15 
54 -63 79 -89 2 0 54 0 2 -89 66 -77 54 54 -53 -88 -39 64 63 -54 86 -71 34 21 82 36 60 -31 -54 2 -63 -53 40 2 54 -15 0 66 29 66 -15 -14 56 5 32 -50 -60 0 -60 -36 46 19 83 9 21 -82 83 -73 44 43 -75 80 -77 29 
0 -39 66 -39 2 16 2 -39 66 -53 -15 0 -24 -88 17 92 -63 -64 -90 23 -71 0 19 19 -12 -84 9 72 -92 89 40 -25 54 -89 -63 -77 66 -15 66 -89 -77 -89 41 -38 31 68 80 56 0 94 -36 0 0 -36 97 0 59 81 80 30 -39 54 -89 -63 
54 -89 54 -77 79 -53 -77 -15 -39 29 16 -88 80 -13 -23 69 67 -25 -28 73 81 0 3 -61 -38 80 -73 48 85 25 78 29 66 29 79 40 -89 66 -63 -89 -15 -39 29 17 -88 91 0 -14 80 80 0 6 -73 -60 46 70 0 19 -50 -13 -76 -39 -89 -53 
79 -15 -15 66 40 -77 79 -63 66 90 17 30 -60 -60 5 -12 55 2 52 -6 7 -76 -65 28 16 -89 68 -60 -95 -55 78 -89 16 29 -77 -89 -15 -39 16 -25 2 -63 -39 66 66 -25 -52 16 0 42 0 31 -36 -21 82 81 -21 -37 31 -13 41 -15 16 -53 
16 -89 -63 79 -25 -25 -89 -25 -39 80 -61 -86 5 44 6 95 -86 56 -65 -68 47 -87 -102 0 39 16 -87 -59 -94 -18 -1 -63 2 0 -77 -25 -39 54 90 54 -53 -25 -77 0 0 -63 0 -15 90 -52 -75 18 43 5 81 -86 43 -86 -87 29 90 66 -15 16 
-39 40 -63 40 -25 -89 66 29 16 29 42 80 -60 0 70 -20 81 3 -40 -82 81 68 64 -104 -68 -17 54 -60 34 -31 87 39 2 -15 -25 -15 2 40 -89 -15 66 -25 79 16 -25 -63 -77 -89 -77 -39 0 56 -61 17 -74 42 -13 -61 -88 90 90 -89 -63 -15 
79 -39 -15 -25 -89 2 40 40 0 91 -38 -22 -60 45 -72 -46 -73 43 -64 -41 -58 81 -25 16 16 -14 80 -47 -32 -67 53 -63 -39 -63 66 -53 0 -15 -77 16 66 79 29 -53 2 16 0 -77 0 16 2 -52 29 67 56 3 -88 -24 -25 -63 40 -89 -63 -89 
66 -89 66 -25 16 2 -63 2 17 -23 57 94 70 -9 34 21 -35 33 55 0 -93 -59 -87 32 -100 -99 33 -71 -57 -91 16 54 40 -25 29 40 0 79 -89 79 -15 29 29 -39 29 40 0 90 -63 -89 16 79 66 2 91 -89 66 -25 2 0 -77 -15 -15 -63 
54 0 -89 0 66 -77 -53 -53 -63 91 30 -50 44 -73 -20 0 8 0 -39 88 12 -82 -10 34 69 71 71 37 -5 -91 0 90 -53 -15 0 0 -39 -89 29 -53 16 79 -77 -53 -63 -89 54 0 90 -15 40 79 -89 -89 79 29 -25 79 -25 29 79 -89 -89 79 
-15 -63 -39 40 0 16 90 40 54 -52 98 93 -11 -73 -60 8 -48 -48 19 -39 -40 23 -45 -44 9 -44 -57 0 -55 -65 0 -77 -89 -39 79 66 -77 29 16 66 -15 -25 2 -77 90 -53 54 16 66 -25 -53 -15 79 40 79 -15 -53 -15 66 29 54 -39 -89 -63 
0 40 90 -53 0 54 -77 -9 59 -70 5 86 -33 50 -60 19 -85 6 -86 5 -77 15 -68 52 -31 87 14 -55 64 2 -53 79 29 -25 -77 79 29 0 -39 -77 79 54 29 2 0 -25 -39 -39 -53 -53 -53 -53 -53 -39 -25 -15 2 16 40 79 -89 -53 -15 16 
0 -77 29 -63 29 -77 0 64 -67 -15 20 39 67 78 74 58 43 18 -12 -61 80 16 -54 53 -29 64 -39 27 -89 -25 16 54 90 -77 -63 -63 -63 -77 90 54 16 -25 -89 29 -39 66 -25 54 -53 16 79 -63 -15 16 40 54 66 66 54 29 2 -25 -77 54 
79 -63 0 90 16 -9 -30 -10 19 95 -5 107 59 44 39 74 -61 30 -51 91 66 79 -89 -25 53 -15 -77 90 90 -63 -15 66 -15 -63 90 90 -77 -15 54 -25 -89 79 66 90 -53 29 -63 66 29 29 40 90 -25 79 2 -25 -39 -15 16 90 0 -63 79 66 
-53 -15 -63 2 -9 90 106 43 86 49 -61 -67 24 43 -10 39 0 80 91 2 40 -15 54 29 -63 -63 67 -89 66 -63 -63 29 54 0 40 2 90 90 2 29 -15 40 16 -89 -77 40 79 29 -89 90 0 2 -53 0 -39 29 29 -53 -25 -89 -25 -53 29 29 
-63 -63 0 -89 71 90 -24 100 80 105 5 -61 117 -43 43 -2 -9 29 -53 90 -77 -15 90 67 91 -14 -87 91 -62 30 -25 -25 16 -63 79 90 -39 66 40 66 -53 66 54 90 -15 -77 -77 -25 66 16 29 90 2 -25 0 54 0 -25 2 79 16 16 54 -39 
66 -77 2 -63 -83 -67 -10 86 20 5 30 72 -26 100 70 77 -59 29 -25 -39 -25 29 -52 80 68 92 -37 56 4 0 17 90 0 -53 -63 -25 40 -39 -89 90 -63 2 -77 79 66 -89 -15 -89 66 66 -89 -15 -89 66 66 -77 0 -77 79 90 -53 16 -39 -77 
2 66 16 35 -53 -73 -5 117 -57 30 13 39 -33 -38 38 -10 14 -59 -77 0 -63 -24 68 57 -86 57 69 -22 -50 0 -75 -62 16 -15 16 -53 -53 16 -25 2 -77 -89 -25 -77 -53 40 16 79 16 29 -77 90 -53 66 66 -39 -77 -39 66 66 -53 90 -77 29 
-53 -77 54 -39 20 64 58 38 -26 60 128 -45 -51 86 9 90 -47 -39 -53 90 3 92 -50 -37 -60 81 0 69 -85 -74 93 31 -62 2 29 29 2 -63 29 90 -63 -77 79 1 -89 -39 -15 -25 -77 40 -63 -15 0 -15 -62 40 -77 -25 -25 -39 90 0 66 -89 
40 40 -53 -39 71 90 19 49 -14 9 -57 -26 105 -57 81 -78 59 -77 66 -63 91 -38 -60 0 -20 59 34 -73 -84 0 0 80 80 -15 0 -89 -77 29 40 -25 0 -78 -39 89 -64 65 -89 54 -89 54 -77 80 -52 -88 -24 -52 17 0 79 54 -53 -53 29 29 
40 90 40 79 8 26 -61 -61 23 15 80 38 86 19 58 -30 -19 79 66 -39 -62 0 -37 6 -48 -19 97 96 0 0 69 42 -88 54 -89 40 66 -15 -15 78 64 -39 -78 -18 -65 -27 -90 -78 40 40 -62 -75 0 -38 18 -24 4 -61 -39 54 54 -39 -63 2 
-15 29 16 -77 -39 -71 26 58 1 81 86 19 81 70 -15 20 0 90 -77 80 -23 -12 -73 0 0 -71 -19 -35 71 -84 81 -22 0 -52 29 29 -25 29 28 -54 -2 -28 77 -80 63 -28 -18 -65 1 3 -61 0 -12 93 -60 -87 5 31 -12 67 79 16 79 79 
90 -89 -63 -25 16 90 -19 77 3 -67 81 39 14 14 20 40 79 -53 2 90 3 -75 57 6 -20 -36 -35 -19 0 44 93 -23 67 -25 90 29 -15 -39 -54 -55 -40 -3 25 87 -18 62 -18 -91 39 3 -12 -23 -22 0 19 70 -48 19 -72 31 -38 -88 66 40 
-53 29 79 79 29 -63 0 8 -19 84 -30 -9 -34 84 -25 2 0 -53 29 79 80 42 -50 6 19 0 -83 -10 7 0 -74 4 41 40 -15 79 -63 -54 89 0 62 87 51 -19 51 87 62 0 89 -52 -60 81 -11 44 46 9 -71 1 8 -11 -86 1 17 2 
29 16 -53 16 16 -25 54 90 54 -25 20 16 -53 16 29 0 79 -77 90 16 67 68 5 80 -85 69 -20 6 0 -74 -12 -13 -62 16 40 2 -77 -26 -39 77 -41 -30 -81 0 37 12 -68 -18 -18 -77 0 5 -21 72 -81 86 10 60 73 7 94 -86 81 -14 
66 -63 -39 -25 -25 -63 79 2 -89 -15 40 79 90 79 54 2 -63 40 -77 -15 16 41 31 5 -37 93 6 80 -37 0 17 17 0 -53 79 0 78 -54 -2 14 13 0 -44 84 0 -95 -32 13 52 53 40 5 -47 60 -31 37 87 -81 -68 -83 72 6 -60 31 
16 16 79 2 2 54 -15 -15 29 -39 -53 0 -77 90 -53 66 40 90 2 -15 16 -63 -88 -51 56 31 69 -23 -61 -23 67 29 66 -25 -63 -39 40 1 27 -79 76 -92 -5 -58 -45 35 -6 0 87 39 54 -62 70 84 -32 99 -80 -18 -81 -70 -9 -73 -74 -13 
2 -63 54 -15 -77 40 -15 -63 66 16 -25 -77 79 29 2 -25 -63 -89 79 54 40 29 16 3 0 0 0 3 3 17 29 40 66 79 -89 -53 -25 1 39 77 -67 -18 23 72 -71 -7 48 -82 -5 63 -53 17 -87 -11 73 -18 63 -30 63 -32 72 -21 93 4 
-25 66 -39 29 -89 -39 2 40 79 -89 -77 -77 -89 90 66 29 -15 -63 66 0 -77 16 -77 2 90 -25 30 79 -77 -39 -15 0 0 0 -15 -39 -63 78 27 -18 -91 25 -55 36 -70 10 84 -45 0 52 89 -77 -50 -48 -45 -44 -67 99 64 11 -46 84 6 -74 
90 16 -25 -39 -39 0 54 -39 66 16 2 2 40 -89 0 -89 54 29 29 54 -77 2 -77 66 29 29 66 -77 2 -77 54 16 16 40 90 -25 79 16 -16 -17 -2 39 -80 23 -31 -70 -82 -71 -19 51 -40 78 40 31 44 97 -32 62 -6 -46 -59 -59 -12 42 
66 54 -39 -15 -77 -25 -53 16 16 -63 -25 -77 -15 -39 40 54 -15 16 -25 40 29 -63 -39 79 -63 -89 -15 -15 90 -77 54 -77 90 -15 0 -89 -53 90 -25 -39 53 63 -3 37 0 73 59 -19 0 -57 0 -30 53 66 -13 19 -20 34 9 -84 -72 44 93 42 
-39 -89 90 -53 40 2 2 66 0 -39 -15 54 -15 -39 0 79 16 2 54 -39 -89 -89 -25 79 40 66 -63 54 29 66 -53 79 66 -77 2 -39 -25 16 -63 90 -89 -26 89 62 87 -30 -93 87 -70 12 -31 -30 14 -65 79 90 -37 81 43 70 -49 82 57 92 
40 79 -39 79 29 29 66 -53 66 16 16 66 -53 66 29 29 79 -25 90 54 54 -89 0 -77 90 -89 -39 40 -25 -53 -39 2 -89 40 16 29 90 -15 -77 -89 -77 -15 78 15 0 14 75 -4 -69 -80 -57 0 -82 60 52 77 -53 53 2 0 32 -86 18 -24 
54 -25 -39 16 -25 -15 79 66 -77 54 66 -39 -77 -25 90 90 -15 -63 -25 79 79 -39 -89 -63 29 16 79 16 29 -63 -89 -39 90 90 -15 -39 0 -77 -77 0 -53 -15 89 78 -40 88 -80 25 0 60 0 10 -97 71 -72 49 60 -56 -91 -54 65 68 -52 90 
-15 16 16 -15 -77 16 79 -89 -89 66 0 79 -53 -25 -39 -77 29 -77 -25 0 -25 -77 29 -77 -39 -25 -53 90 2 66 -77 -77 90 29 -63 0 29 29 0 -77 16 79 -89 89 53 -18 63 -79 -55 -69 72 -9 70 -74 -61 -74 58 -21 50 -93 -92 78 16 -63 
-25 -25 79 90 2 16 -63 -39 79 -77 40 79 16 54 2 54 2 54 16 66 29 -89 66 -53 -77 0 -15 66 54 -53 -53 29 40 -53 -53 54 66 0 2 -63 -39 79 -77 54 89 27 78 16 62 25 73 34 -98 55 -63 -88 -12 -38 47 22 -82 -79 1 2 
-25 16 -25 0 -77 -63 40 29 -77 90 -25 -77 -25 -89 -63 54 66 -25 -39 40 16 79 29 79 16 40 -39 -25 66 54 -63 -89 -39 -89 -39 79 -89 16 29 -77 -89 -15 -39 2 -39 0 -78 -54 52 51 -57 -73 -3 -39 2 -42 -5 -77 -61 46 49 -56 -78 0 
40 -89 90 2 54 16 -77 -39 -89 0 2 -53 2 2 -63 -15 -25 66 -89 79 -25 0 -53 16 16 -39 16 2 -63 -15 -39 54 79 40 -63 -53 90 -39 -39 79 -53 -63 40 79 40 -53 -25 -77 0 0 -57 9 -4 -77 -28 -55 39 78 43 -60 -33 -93 -18 0 
-53 -63 -63 -39 -15 29 90 -15 66 -15 -89 54 2 -15 -25 -25 0 29 79 -53 29 -63 40 -25 -77 79 54 40 54 79 -77 -25 40 -63 29 -53 79 16 0 -25 -25 -25 0 40 90 -25 54 -25 78 15 -30 -58 -85 -87 -78 -41 -5 54 -62 20 -57 62 0 -39 
66 29 -63 0 16 -15 -89 -15 2 -15 -77 2 40 29 -15 79 -63 -53 90 2 79 90 66 0 66 90 79 16 -89 -39 -53 90 0 54 66 16 -53 2 29 2 -63 2 40 29 -25 66 -89 -89 53 -28 24 35 -3 -87 -14 2 -15 -89 -3 32 21 -19 63 -78 
16 16 -39 29 40 2 -89 -53 -77 40 -89 -89 54 -63 -39 -77 29 79 54 0 54 66 16 -89 -63 -89 16 66 54 0 66 79 40 -63 -25 -53 66 -77 -77 66 -53 -25 -63 29 66 54 -15 40 40 -1 76 -94 72 -22 19 5 -50 4 19 -8 74 -80 89 1 
29 54 54 29 0 -63 40 -53 16 66 90 90 79 40 -15 -89 0 66 -63 -39 -25 -39 -77 54 -15 79 -39 16 54 66 54 16 -25 90 0 79 -53 -25 0 -15 -39 -89 29 -53 16 79 -63 -53 -53 -77 64 -4 -94 -7 46 -98 -73 -74 -96 49 -4 -91 -1 65 
54 -53 90 -89 0 -53 -25 40 0 2 79 29 40 -77 54 66 -63 66 79 -53 79 79 -39 79 79 -53 66 66 -63 54 40 -89 16 2 66 -15 -25 16 -63 -77 -25 79 54 -89 16 0 29 -63 -89 -53 54 15 50 -43 -82 -45 49 10 37 -56 88 -79 16 -26 
40 90 -53 0 54 -77 -15 40 -77 -15 54 -53 16 -89 0 90 -15 79 -15 79 0 -89 16 -63 54 -15 -89 29 -25 -89 40 -15 -63 66 16 -15 -63 90 54 29 0 -25 -53 -77 -89 90 79 66 66 66 66 66 78 88 -92 -81 -55 -42 -19 15 39 78 -78 -25 
79 0 -89 2 90 -15 54 -77 -25 2 40 66 79 90 90 79 54 16 -15 -63 66 2 -63 40 -53 29 -77 0 54 -77 -25 2 29 40 54 54 40 29 2 -25 -77 54 0 -77 29 -53 40 -63 2 66 -63 -15 16 53 78 88 89 77 64 39 0 -26 -77 54 
-63 -15 66 -15 -77 90 79 -89 -25 40 -39 90 54 54 66 -77 2 -89 40 2 0 16 54 -63 40 -25 -63 -77 -63 -15 40 -53 79 29 16 29 66 -53 29 -39 -77 90 -89 -53 2 -89 16 -25 -39 -39 0 54 -53 66 1 -16 0 16 78 -26 78 29 0 0 
