-2 -3 0 -3 -2 -3 -2 -3 0 0 -3 0 -3 0 0 -3 -3 0 -3 0 -3 -3 0 0 -2 0 -1 -3 -3 -1 0 -2 0 0 -3 -3 0 -3 0 -3 -3 0 0 -3 0 -2 0 0 -3 -1 -3 -1 -3 -3 -3 -1 0 -2 0 0 -3 -3 -3 -3 
-3 -1 -3 -3 -3 0 -3 -3 -2 -3 -3 -3 -3 -3 0 0 -3 0 0 -3 -3 -3 -3 -3 0 -1 0 0 -3 -3 -3 0 -3 -3 -3 0 -2 -3 0 -3 0 -3 -3 0 -1 0 -3 -1 -3 -1 -3 0 0 0 -3 -3 -3 -3 0 -1 0 -3 -1 -3 
0 -3 -3 0 -2 -3 0 -3 -2 -3 -3 -3 -3 -2 -3 -3 -2 -3 -2 -3 -3 -2 -3 -1 -3 -3 0 -3 0 -2 -1 0 -3 0 0 0 -3 -2 -3 -3 -3 -3 0 -2 -3 -3 0 -3 -3 0 -3 -3 0 -3 -3 -3 0 -3 -3 -3 -3 -3 -3 0 
-3 0 0 -3 -3 -3 0 0 -3 0 -3 -3 -3 0 -3 -2 -3 -3 -3 0 -3 -3 -3 -3 -3 -3 -3 -3 -3 -3 0 -3 -3 -3 0 -2 0 -2 -1 -3 0 -3 0 0 -3 -3 -3 0 0 -3 -3 -3 0 0 -3 0 0 -3 -3 -3 -3 -3 0 -2 
-3 -3 0 -3 0 -3 -3 -4 -3 -3 -3 0 0 0 -3 -3 -3 -1 -1 -3 -3 -1 0 -3 -3 0 -2 -3 -3 -3 -3 -3 0 -3 -3 -2 -3 -3 0 -3 -3 -3 -3 -3 -1 -3 -3 -3 -3 0 -3 -1 0 0 -1 -3 0 -3 -3 -3 -3 -1 -3 -3 
0 -3 -2 -3 0 -3 -4 -2 -4 -4 -3 -3 -3 -2 -3 -3 -1 0 -3 -3 0 0 -3 -2 -3 -3 -3 -3 0 -3 0 0 0 0 0 -3 0 -3 -3 -3 -3 -2 -3 0 0 -3 -3 0 0 -3 -3 0 0 -3 -3 -3 -3 0 0 -1 0 -3 0 -3 
-3 -3 0 0 -3 -4 -3 -5 -4 -5 -5 -3 -3 -4 -5 -3 -3 -1 -3 -1 -3 -3 0 0 -3 -3 0 -3 0 -3 0 -3 -3 0 0 -3 -3 -1 -3 0 -3 -2 -3 -3 0 0 -3 -3 -3 -3 -3 -3 -3 0 0 -3 -3 0 0 -3 0 -3 0 0 
0 0 -3 -3 -3 -5 -5 -3 -5 -5 -5 -5 -5 -5 -5 -4 -3 0 0 -3 -3 -3 -3 -1 -3 -1 -2 -3 -3 -3 0 0 0 -3 -3 0 -3 -3 0 -3 -3 0 0 0 -3 -3 -3 -2 -2 -3 0 0 0 0 6 2 0 2 0 -3 -3 -3 -3 -3 
-3 -3 -3 -3 -3 -2 -4 -3 -5 -4 -4 -5 -5 -5 -5 -5 -5 -4 0 -4 0 -3 -3 0 -1 -3 -3 -3 -2 0 0 -3 0 -3 0 -3 -3 0 0 0 0 0 -3 -3 0 -3 0 -3 -3 0 0 6 6 6 10 7 5 6 3 0 -3 0 -3 -3 
-3 -3 0 -3 0 -3 -2 -5 -5 -4 -5 -5 -5 -5 -5 -5 -5 -3 -4 0 -4 0 -1 -3 -3 -3 0 -3 0 0 -3 0 -3 -3 -3 0 -3 -3 -3 0 -3 -3 -3 -3 0 -3 -3 0 0 6 7 10 10 10 17 11 10 13 5 5 2 -3 -1 0 
-2 -3 -3 -3 -3 -3 -3 -4 -3 -5 -5 -5 -5 -4 -5 -5 -5 -5 -5 -2 -2 -3 0 0 -1 0 -3 0 -1 0 0 -3 0 0 -1 -3 -3 -3 0 -3 -3 0 -3 -3 -3 -1 0 2 6 7 11 17 18 15 22 17 17 17 10 6 6 0 -3 -3 
-3 -3 -3 -3 -3 -3 -3 -5 -5 -5 -5 -5 -5 -5 -5 -5 -5 -4 -5 -5 -2 -4 -3 -3 0 0 -3 0 0 -3 -2 -3 -3 -3 0 -2 -3 -3 0 0 0 0 0 -3 -3 -1 0 0 6 10 17 19 19 19 25 19 19 19 17 10 6 0 1 -3 
-3 0 -3 -3 -3 -3 -1 -4 -4 -5 -5 -5 -5 -5 -5 -5 -5 -5 -5 -4 -3 -4 0 0 -2 -3 -3 0 -3 -3 0 -3 -3 -3 -3 -3 -3 0 0 -3 0 0 -3 -1 -2 0 0 6 10 15 19 19 26 26 31 25 25 20 19 17 9 6 0 -2 
0 0 0 -3 -3 -3 -3 -3 -3 -5 -5 -5 -5 -5 -5 -5 -5 -5 -3 -5 -3 -4 -3 -3 0 0 0 0 0 -3 0 -3 0 -3 0 -1 -3 0 -2 -3 -3 0 -3 -3 -3 0 0 6 10 16 19 26 31 31 35 31 30 26 20 17 10 6 0 0 
-2 -2 -2 -3 -3 -3 -1 -4 -5 -3 -5 -5 -5 -7 -6 -5 -6 -5 -5 -5 -5 -3 -3 0 0 0 0 0 -3 0 -2 0 -2 0 -3 0 -3 -3 0 -3 -3 -3 -3 -3 -2 -3 0 7 13 18 20 28 32 34 40 33 32 24 20 17 13 5 0 -3 
0 0 0 -3 0 -3 -3 -4 -5 -5 -5 -5 -5 -5 -6 -6 -5 -5 -5 -5 -5 -5 -5 -5 -3 -5 0 -2 0 0 0 0 -3 0 -3 -3 -3 -3 -3 0 -2 -3 0 0 0 2 8 18 23 28 32 42 46 47 53 45 34 28 25 19 17 9 6 0 
-3 0 -3 0 -3 -3 0 0 -4 -2 -3 -5 -5 -4 -5 -5 -6 -7 -5 -5 -8 -5 -5 -5 -5 -5 -5 0 -4 -1 0 0 -3 -3 0 -3 -3 -1 0 -2 -1 0 0 1 0 6 14 21 29 37 39 51 52 56 56 48 42 32 21 17 10 6 0 0 
-3 0 0 0 -3 0 0 -4 -5 -5 -5 -5 -3 -5 -3 -5 -5 -5 -8 -6 -9 -9 -9 -5 -6 -6 -6 -6 -7 -4 -1 -1 -1 0 -3 0 -1 0 -2 0 0 0 1 2 8 13 19 34 44 47 53 60 64 60 66 57 52 41 30 18 10 8 1 0 
0 -3 -3 -3 -3 0 -3 -3 0 -4 0 -1 -1 0 0 0 0 -3 -4 -6 -5 -10 -13 -12 -11 -8 -9 -7 -8 -5 -8 -1 -2 -1 -4 -1 -3 -2 -1 0 0 4 5 11 15 22 31 43 52 58 62 69 72 70 69 66 57 47 40 28 14 6 0 -3 
0 -3 0 -3 -3 -3 0 -3 -3 0 0 1 5 6 7 4 5 4 0 -3 -5 -12 -13 -13 -14 -13 -16 -16 -13 -9 -12 -11 -6 -7 -6 -3 -1 0 0 2 2 4 12 15 26 28 41 47 56 66 71 78 79 73 77 63 64 51 46 33 16 6 0 -1 
-3 -3 0 -3 -3 -1 -3 -3 0 0 4 8 9 10 17 15 10 9 1 0 -4 -8 -13 -15 -18 -18 -19 -24 -26 -18 -20 -19 -14 -14 -14 -9 -3 0 2 2 4 10 18 24 33 41 48 58 66 74 76 85 85 79 84 70 66 61 45 36 25 13 -1 -3 
0 -3 0 -3 0 -3 -3 0 2 6 9 13 18 18 21 19 18 17 10 5 0 -6 -12 -18 -25 -27 -30 -31 -30 -28 -28 -28 -19 -20 -18 -16 -11 -6 1 3 7 13 22 32 41 49 53 63 74 85 83 92 89 85 88 78 66 62 47 37 22 11 1 -3 
0 -3 -3 0 0 -3 0 0 6 10 14 19 22 23 27 25 25 21 17 11 1 -7 -17 -23 -30 -37 -37 -43 -40 -38 -37 -37 -28 -27 -26 -22 -17 -12 -2 8 13 18 28 39 47 53 64 70 76 91 89 97 95 90 94 84 71 62 48 42 27 16 8 -2 
-2 -3 -3 0 -3 -3 0 2 7 16 18 21 28 30 33 32 29 26 19 12 8 -7 -18 -28 -37 -46 -46 -51 -50 -47 -45 -44 -37 -35 -30 -28 -19 -18 -6 2 14 23 33 44 55 61 69 80 86 94 98 104 102 98 98 85 78 63 53 37 31 19 10 2 
-3 0 -3 0 -3 -3 0 3 8 14 19 26 30 35 41 38 39 31 24 15 6 -5 -19 -33 -45 -49 -50 -56 -56 -53 -51 -52 -45 -42 -37 -32 -27 -18 -16 -5 9 25 37 47 55 66 75 87 94 101 104 109 104 102 97 84 74 62 50 42 31 18 9 1 
0 -3 -3 -3 -3 -3 0 3 8 17 19 26 32 40 43 44 40 35 24 18 6 -7 -22 -37 -43 -52 -57 -63 -64 -62 -58 -57 -53 -49 -45 -37 -34 -25 -16 -9 5 21 37 45 58 67 77 88 95 105 113 114 113 105 97 85 72 62 50 38 28 18 9 1 
0 -3 0 -3 -2 0 0 7 14 18 26 32 39 42 51 51 47 39 31 20 9 -5 -20 -28 -44 -57 -58 -69 -71 -67 -68 -66 -57 -56 -51 -43 -33 -24 -20 -4 7 26 42 52 65 75 85 96 104 112 118 128 124 113 105 91 83 67 56 46 35 25 13 5 
0 -3 -3 -3 0 -3 0 1 6 16 19 24 32 38 43 43 41 37 28 18 3 -12 -27 -38 -46 -56 -66 -69 -77 -76 -75 -73 -66 -60 -59 -51 -43 -33 -21 -17 0 18 34 48 59 70 80 90 101 108 115 123 117 109 101 87 75 67 54 43 34 20 12 6 
-3 -3 -3 0 -3 -2 0 3 9 13 19 26 31 34 40 40 39 33 29 17 3 -11 -27 -38 -47 -61 -69 -76 -79 -82 -81 -80 -75 -69 -60 -55 -47 -37 -27 -18 -6 13 31 43 57 65 76 87 94 103 104 112 112 105 96 83 71 60 51 38 28 18 9 1 
-3 0 0 -3 -3 0 0 1 8 13 18 23 27 29 35 36 37 30 25 18 4 -9 -24 -34 -47 -55 -62 -74 -78 -85 -86 -85 -76 -73 -65 -54 -48 -39 -29 -18 -4 11 28 42 52 63 70 81 87 95 98 102 99 95 88 82 72 60 49 39 26 16 9 1 
-3 -3 -1 -3 -1 -3 0 0 4 7 13 19 23 26 29 29 31 29 19 10 0 -13 -28 -37 -48 -56 -66 -71 -82 -85 -92 -92 -84 -77 -72 -62 -55 -47 -37 -26 -13 2 18 37 43 55 63 77 84 86 89 90 90 85 84 74 66 56 46 37 28 17 9 2 
0 -3 -3 0 -1 -3 -3 0 1 6 9 17 17 19 23 23 23 24 18 9 -2 -14 -28 -37 -47 -56 -64 -69 -76 -85 -93 -91 -86 -81 -73 -66 -62 -51 -42 -31 -25 -4 9 25 36 47 51 64 72 78 78 84 78 76 72 65 56 47 37 29 22 12 6 2 
-3 -3 -3 -3 -3 0 0 0 0 3 4 9 10 13 17 17 18 17 15 9 -3 -14 -23 -32 -41 -50 -56 -66 -71 -76 -84 -85 -84 -79 -72 -66 -59 -50 -41 -30 -24 -9 7 18 25 35 47 51 58 68 66 69 68 65 61 56 50 40 33 26 19 9 2 0 
-3 -3 -3 -3 0 0 -3 0 0 0 0 3 7 6 10 9 9 10 6 4 -9 -18 -25 -30 -38 -48 -56 -57 -68 -73 -76 -81 -78 -78 -74 -67 -64 -54 -47 -36 -32 -18 -2 9 21 21 33 41 48 54 56 62 58 53 54 47 41 33 28 20 13 6 2 -2 
0 -3 -3 -3 -3 -3 -3 0 -3 -3 0 0 0 3 6 4 2 4 0 -3 -10 -18 -25 -27 -36 -43 -52 -56 -61 -64 -71 -74 -73 -77 -73 -69 -63 -56 -54 -40 -37 -24 -17 0 9 16 23 33 36 42 42 48 47 47 45 39 31 28 20 15 6 2 -2 -3 
-3 0 -1 0 -3 -3 -3 0 -3 -3 -3 -2 -3 -3 0 -2 0 -2 -3 -1 -9 -16 -20 -27 -32 -36 -42 -51 -57 -56 -64 -69 -66 -71 -70 -65 -64 -56 -48 -45 -38 -28 -22 -15 -6 8 13 22 27 31 31 41 37 38 40 31 23 19 17 8 1 0 -3 0 
-3 -3 0 -3 0 0 0 0 -3 0 0 -3 -3 0 -3 0 -3 -3 -3 0 -4 -9 -18 -22 -29 -35 -36 -44 -52 -52 -56 -62 -65 -64 -65 -64 -58 -56 -52 -43 -40 -30 -22 -21 -18 -7 0 9 13 20 23 31 33 31 32 28 20 18 12 2 0 0 0 -3 
0 0 -3 -3 0 0 -1 0 -3 -2 -3 -3 0 -3 0 -3 0 -3 0 -3 0 -9 -16 -21 -22 -27 -32 -37 -42 -43 -50 -55 -54 -59 -58 -57 -56 -54 -47 -44 -38 -33 -28 -21 -22 -17 -13 -2 6 12 17 27 26 23 29 21 20 14 15 4 2 -2 0 0 
0 0 0 0 -2 0 -3 -3 0 -1 0 0 0 -2 0 -3 -3 0 0 0 0 0 -9 -14 -21 -21 -25 -26 -34 -37 -41 -48 -48 -48 -56 -49 -53 -48 -48 -38 -36 -32 -32 -28 -25 -23 -20 -9 0 5 11 18 21 20 28 20 20 14 12 9 9 2 -3 -3 
-3 0 0 -3 -3 -3 0 0 -1 0 0 0 0 0 -3 0 -2 0 -3 0 0 0 0 -6 -14 -18 -20 -26 -25 -29 -34 -40 -39 -44 -46 -46 -46 -44 -40 -39 -36 -34 -31 -30 -25 -23 -15 -8 0 5 13 18 22 25 28 20 21 21 20 15 14 9 2 0 
0 -3 -3 -3 0 0 -2 0 0 -3 0 0 0 -1 0 0 0 -3 0 0 0 0 0 0 -6 -10 -14 -18 -21 -21 -28 -34 -32 -37 -38 -39 -41 -38 -37 -37 -39 -36 -34 -28 -29 -19 -12 -6 0 8 11 21 22 28 35 29 28 29 19 20 12 11 9 2 
-3 0 0 0 0 -3 -1 0 -2 0 -3 -2 -3 0 -3 -1 0 -3 0 0 0 0 0 0 0 -4 -8 -11 -11 -14 -23 -24 -24 -28 -30 -30 -32 -34 -30 -34 -36 -34 -33 -31 -21 -13 -6 -3 6 12 16 30 30 33 40 34 31 34 28 24 18 12 12 6 
0 -1 -3 0 0 -3 0 0 0 -2 0 0 -3 0 0 0 0 -3 0 0 0 0 0 1 0 1 0 -5 -5 -6 -13 -17 -18 -20 -24 -26 -28 -28 -32 -31 -35 -34 -34 -31 -23 -16 -9 0 9 12 22 32 37 39 38 40 39 39 35 26 27 18 12 6 
0 -3 -3 -3 -3 -3 0 0 -3 -2 0 0 0 0 0 0 -3 0 -3 0 0 0 0 0 0 1 0 0 -1 -4 -5 -12 -12 -16 -17 -21 -23 -25 -28 -29 -31 -31 -31 -22 -18 -13 -3 0 8 18 23 32 35 39 39 39 41 38 30 30 26 18 18 12 
-2 -1 0 -3 -2 0 -3 -3 0 -3 -3 0 -3 0 -3 0 0 0 0 0 0 0 0 0 0 0 0 0 0 -3 -5 -7 -11 -12 -17 -18 -22 -25 -26 -28 -28 -28 -28 -23 -18 -10 -3 6 8 17 23 24 37 36 39 39 38 33 31 30 25 22 18 11 
-3 -3 0 -3 -3 0 -3 -3 0 0 -2 -3 0 0 0 -3 -3 -3 0 0 0 0 0 0 0 0 0 0 0 0 -4 -5 -8 -11 -15 -17 -19 -23 -23 -22 -28 -26 -26 -19 -17 -9 -1 -1 4 11 13 25 30 30 30 35 37 30 29 26 21 20 19 11 
-3 0 -3 0 -3 -3 -2 0 0 -3 -3 -3 -3 0 0 0 0 -3 0 0 0 0 0 0 0 0 0 0 0 0 -3 -5 -8 -10 -12 -15 -17 -16 -19 -21 -23 -22 -24 -18 -14 -9 -4 -4 -5 5 0 7 15 19 18 24 19 21 14 21 15 15 12 11 
0 -2 -3 -3 -3 -3 0 -3 0 0 0 0 0 -3 -1 -3 0 0 0 0 -1 0 0 0 0 0 0 0 0 -3 0 -3 -5 -6 -6 -12 -12 -12 -18 -18 -20 -18 -17 -12 -7 -7 -7 -7 -1 -2 0 0 7 12 11 17 10 10 14 12 20 15 12 12 
0 0 -3 -3 -3 -3 -3 -1 0 -3 -3 -3 -3 -3 0 0 -1 0 0 0 0 0 0 0 0 -1 0 0 0 -3 0 -3 -3 -5 -8 -9 -12 -11 -13 -16 -16 -14 -18 -13 -15 -13 -16 -15 -15 -16 -12 -14 -8 -3 -5 0 -5 -7 -2 -9 0 9 4 2 
-3 -3 0 -3 0 -3 -3 0 -3 -3 -3 0 -3 -3 -1 0 0 0 0 -2 -3 -3 0 0 0 0 0 0 0 0 -3 0 0 -5 -5 -6 -9 -9 -12 -9 -14 -13 -12 -10 -10 -15 -15 -19 -21 -18 -26 -29 -23 -25 -24 -18 -17 -17 -12 -8 -10 -3 3 2 
0 0 -3 0 -1 -1 0 -3 0 0 0 0 -3 0 0 0 0 -3 0 0 0 -3 0 -3 0 -3 0 0 -1 -3 -3 -1 -3 0 -3 -3 -5 -7 -9 -10 -12 -12 -11 -12 -14 -18 -23 -19 -24 -33 -37 -51 -45 -44 -45 -40 -37 -39 -25 -18 -13 -7 -6 -3 
0 -3 -3 -2 -3 -3 0 0 -3 0 0 -3 -3 -3 0 0 -3 -3 -3 0 0 -3 -3 -3 0 0 0 0 0 -3 -3 -3 0 0 -3 -3 -4 -5 -5 -5 -9 -9 -5 -7 -12 -12 -22 -29 -38 -47 -56 -55 -68 -67 -69 -62 -56 -42 -45 -32 -26 -20 -6 0 
-3 -2 -2 -3 -3 -2 0 -3 -3 0 -3 0 -3 -3 -3 -3 0 -3 -3 -2 -3 -3 0 -3 -2 -2 -3 0 0 0 -3 -3 0 0 -3 -1 0 -1 -3 -5 -5 -3 -5 -9 -13 -18 -26 -29 -40 -55 -61 -73 -85 -91 -90 -82 -75 -59 -48 -41 -26 -21 -13 -7 
-3 -3 0 0 -3 -2 -3 -3 0 -3 0 0 0 0 -1 0 -1 0 0 0 0 -3 0 -3 -3 -2 -1 0 0 -3 -3 0 0 -3 -3 0 0 0 -1 -4 -4 -3 -5 -8 -13 -18 -26 -37 -47 -55 -70 -79 -97 -108 -112 -104 -85 -69 -57 -42 -35 -28 -18 -7 
-3 -2 -3 -3 -3 -3 0 -1 -3 0 -3 -3 -3 -3 -3 0 0 -3 -3 0 0 0 0 0 0 0 -3 -2 0 0 -3 -3 -3 -3 -3 0 -3 0 0 -4 -5 -4 -9 -15 -20 -31 -37 -46 -58 -68 -86 -94 -108 -126 -127 -117 -99 -85 -74 -56 -46 -33 -30 -22 
0 -3 0 -3 0 -2 -3 -3 -3 -3 -3 -3 -2 -2 -3 -3 -3 0 -3 0 -3 -3 -3 0 0 -3 0 -1 -3 -2 -3 0 0 0 -3 -3 0 -3 -3 0 -4 -5 -2 -6 -14 -23 -33 -37 -48 -62 -75 -86 -99 -114 -117 -112 -94 -77 -59 -53 -37 -33 -23 -17 
-3 -3 -3 -3 -3 -1 0 -3 0 -3 -3 0 -2 -3 -3 -3 -3 0 0 -3 0 -3 0 -3 -3 0 0 0 0 0 -3 -2 0 -3 0 -3 0 0 -2 -3 -3 -3 -4 -6 -10 -23 -35 -39 -50 -66 -74 -89 -103 -104 -109 -101 -95 -82 -66 -56 -42 -37 -27 -17 
0 -1 -3 -3 -2 -3 -3 -3 -3 -3 -3 -3 0 0 -3 0 -3 -3 0 -3 0 0 0 -3 0 0 0 0 -3 -3 -3 0 -1 0 0 0 -3 0 0 -1 -3 -3 -1 -6 -13 -19 -34 -43 -50 -67 -75 -76 -90 -95 -95 -89 -88 -74 -68 -57 -42 -41 -27 -17 
-2 -2 -3 -1 0 -3 -3 -3 -3 0 -3 -3 0 -3 -3 -3 0 0 0 -3 0 0 -1 -3 -3 -3 0 0 0 -2 0 0 0 -3 -3 -3 0 -3 -3 0 -3 -3 -3 -6 -9 -15 -32 -35 -42 -55 -65 -78 -75 -81 -84 -77 -77 -73 -57 -50 -41 -31 -26 -17 
-1 0 0 -1 -3 -3 0 -3 -2 0 0 0 0 0 -3 -3 -3 0 -3 -3 -3 -3 -3 0 -3 0 -3 0 0 0 0 0 -2 0 -2 0 -3 -3 -3 -3 -3 -3 0 -3 -6 -9 -17 -32 -41 -41 -54 -66 -68 -70 -73 -69 -67 -65 -53 -41 -39 -30 -17 -9 
0 -3 0 -3 -3 -3 -3 0 -3 -3 0 -1 0 -3 0 0 -3 0 0 -3 0 0 -3 0 0 -3 0 0 -3 0 0 -3 0 -2 0 -3 -3 0 -3 -3 -3 0 0 -3 -6 -10 -15 -17 -32 -41 -41 -48 -48 -54 -64 -52 -48 -48 -41 -40 -26 -18 -17 -11 
0 0 -3 -3 0 -3 -3 0 -3 -3 0 -3 -2 -3 -3 0 -3 0 -3 0 -3 -3 -1 -3 0 -3 -3 0 -3 -3 0 -3 -3 0 0 -3 -3 0 0 0 -3 -3 -3 -3 -3 -6 -9 -14 -14 -28 -31 -40 -41 -41 -47 -41 -41 -41 -28 -27 -17 -14 -11 -7 
0 -3 -3 -3 0 -3 0 -3 -3 -3 0 0 0 0 0 0 0 -2 -3 -3 0 -3 -3 0 -3 0 -3 -3 0 -3 -3 -2 0 0 0 0 0 0 -3 -3 -3 0 -3 -3 -1 -3 -6 -11 -16 -14 -27 -27 -27 -31 -38 -27 -26 -27 -27 -16 -17 -11 -7 0 
-3 -3 0 -3 -3 0 0 -3 -3 0 -3 0 0 0 0 -3 -3 -3 0 -3 -3 -2 0 -3 0 -3 -3 -3 -3 -3 0 -3 0 0 -1 0 0 -3 -1 -3 -3 0 -3 -3 -3 -3 -2 -6 -11 -11 -16 -15 -17 -14 -27 -17 -17 -17 -14 -12 -9 -6 -3 -3 
