-121 -121 -119 -120 -118 -117 -109 -107 -101 -100 -105 -108 -115 -107 -118 -120 
-121 -119 -118 -118 -118 -113 -100 -93 -89 -91 -97 -92 -100 -88 -107 -112 
-119 -118 -118 -112 -101 -93 -76 -61 -72 -73 -71 -61 -70 -71 -93 -93 
-120 -117 -109 -95 -76 -54 -35 -27 -39 -43 -45 -33 -34 -36 -67 -84 
-116 -107 -89 -66 -28 -2 15 21 13 17 7 0 2 2 -33 -67 
-115 -102 -80 -49 -9 18 56 58 40 31 20 22 20 10 -34 -70 
-103 -82 -54 -10 31 73 125 128 108 84 68 60 32 31 -23 -54 
-109 -98 -72 -33 15 58 109 105 76 52 26 27 11 16 -49 -73 
-108 -95 -75 -37 2 39 83 89 71 50 10 5 0 5 -41 -63 
-109 -101 -89 -56 -34 4 45 45 18 1 -18 -9 -16 -12 -48 -68 
-112 -107 -95 -81 -62 -45 -16 -9 -30 -35 -38 -33 -29 -19 -44 -60 
-115 -112 -107 -98 -78 -66 -48 -54 -54 -51 -54 -45 -39 -22 -45 -60 
-118 -115 -112 -103 -92 -88 -69 -74 -75 -84 -82 -64 -59 -45 -63 -78 
-120 -118 -117 -115 -107 -105 -91 -98 -98 -105 -99 -81 -82 -63 -86 -89 
-123 -120 -118 -118 -118 -116 -107 -112 -110 -112 -116 -107 -108 -89 -111 -112 
-123 -123 -121 -121 -118 -118 -118 -118 -118 -118 -118 -119 -123 -112 -127 -128 
