31 -4 59 24 33 17 33 20 54 59 24 39 20 44 39 7 13 54 0 54 13 7 44 54 31 50 33 0 0 33 50 31 54 44 7 13 54 0 54 13 7 39 50 20 39 31 59 59 24 33 20 33 24 -4 -4 33 50 31 59 50 17 20 0 17 
7 33 13 7 20 50 31 24 44 13 0 3 20 -4 50 59 17 59 54 -4 20 7 3 20 54 33 39 59 24 17 20 50 20 17 20 54 31 24 44 7 59 -4 13 50 33 39 0 33 24 33 0 44 39 54 17 0 0 17 54 33 39 0 33 24 
54 -4 20 59 39 33 50 7 44 24 24 33 -4 33 20 20 31 -4 31 20 20 31 -4 33 20 20 39 3 44 31 33 50 17 59 44 50 0 31 7 0 3 20 54 31 20 24 50 17 -4 54 -4 17 50 24 20 24 50 20 0 -4 3 24 -4 44 
13 54 54 17 0 17 54 50 7 59 0 33 31 54 31 33 3 -4 13 59 -4 20 13 20 0 0 24 13 20 -4 59 17 -4 3 39 31 54 31 33 3 59 7 54 54 17 3 17 59 59 17 0 7 44 39 -4 44 54 20 13 24 7 13 39 31 
0 -4 50 20 50 0 3 -4 44 17 39 59 59 50 31 0 20 33 33 20 3 33 59 3 0 54 31 -4 17 20 20 3 44 7 20 31 24 7 50 7 20 24 20 0 33 -4 7 13 3 50 17 33 50 50 33 17 44 0 7 7 -4 33 0 17 
44 24 44 31 54 39 -4 54 7 3 24 20 50 50 13 13 39 44 13 13 50 54 24 31 7 17 -4 3 50 -4 44 59 39 59 44 -4 50 3 -4 17 7 31 24 54 50 13 13 39 39 7 13 44 50 20 20 0 7 50 59 33 50 24 39 20 
20 20 54 50 13 0 20 3 20 -4 3 44 44 13 3 31 20 39 20 33 13 20 59 59 20 17 41 24 44 24 39 17 20 59 59 20 17 33 20 39 20 31 7 17 50 50 13 3 20 13 24 7 17 59 -3 24 20 54 44 0 50 0 44 54 
54 50 20 33 24 -4 3 54 17 20 3 20 20 0 17 13 44 59 50 13 20 3 27 33 15 33 30 0 19 10 46 54 39 3 7 59 13 17 59 7 3 39 54 44 13 20 3 31 31 13 35 32 9 21 20 55 0 55 18 20 3 24 24 7 
3 3 7 17 31 54 13 39 13 54 31 17 7 3 3 13 20 33 59 20 50 22 -2 48 35 23 25 23 30 44 62 15 39 7 44 20 3 59 50 50 50 59 3 20 44 7 39 17 -4 41 32 23 23 28 38 53 6 28 61 21 0 44 24 17 
-4 31 59 -4 54 31 59 3 0 44 13 20 24 13 44 0 3 59 31 59 0 63 35 0 13 9 63 25 40 40 23 63 15 17 7 50 7 17 7 54 17 24 24 13 44 -4 -4 50 21 43 53 45 21 45 56 49 25 58 6 6 55 20 33 39 
31 3 20 20 3 24 31 20 54 0 -4 33 59 59 33 0 7 -4 31 46 44 23 46 54 34 68 13 68 34 59 51 25 54 56 33 3 17 7 50 3 3 50 7 17 3 33 54 51 23 47 49 31 66 5 68 27 46 46 21 43 47 26 -4 3 
0 20 31 39 39 33 20 0 33 0 20 39 50 50 39 24 7 50 15 35 58 0 8 4 61 36 12 40 71 22 27 28 23 10 62 31 0 20 39 54 59 59 44 24 3 33 0 21 33 38 36 28 15 61 30 57 10 25 27 25 20 0 45 13 
0 54 0 24 17 20 59 39 50 13 0 3 31 17 20 50 31 33 0 48 56 16 71 71 29 6 13 31 12 10 33 8 5 23 -2 -4 17 59 54 7 50 44 -4 33 31 50 21 20 35 9 2 19 59 50 65 30 27 33 2 60 3 33 21 31 
39 50 59 0 7 20 31 44 59 7 20 39 59 13 31 54 13 31 62 21 51 10 39 6 39 74 40 74 39 6 40 10 51 21 62 33 13 59 31 17 -4 44 24 13 -4 50 35 23 17 9 2 63 54 51 46 41 36 34 33 31 29 33 35 39 
31 31 31 20 17 3 54 33 17 59 24 0 31 -4 20 39 -4 13 26 36 51 58 60 62 59 51 41 28 9 53 27 68 28 63 22 50 7 24 44 -4 7 17 20 20 20 20 15 6 58 39 28 3 45 19 54 19 45 3 25 39 58 1 9 17 
39 44 59 13 44 17 0 -4 -4 7 24 -4 31 17 7 7 20 41 8 44 28 21 22 35 53 19 60 36 28 26 31 44 8 40 21 6 0 7 20 54 20 0 54 50 59 9 33 3 50 38 34 41 56 17 50 32 10 5 7 19 39 7 47 26 
7 50 0 54 13 13 50 59 33 59 50 13 13 54 -4 44 2 -5 24 33 14 24 18 40 37 11 26 73 19 12 33 34 5 12 62 13 7 33 39 17 24 17 39 33 3 13 61 10 0 27 28 69 13 62 17 6 36 34 10 23 3 23 21 54 
20 59 50 59 17 59 54 -4 20 7 3 20 54 33 39 -5 29 18 22 47 21 16 22 56 34 25 49 18 4 3 27 63 46 54 6 44 33 44 8 54 50 -4 20 7 7 20 -3 53 58 13 57 43 54 18 62 54 71 30 10 9 25 56 41 39 
39 13 0 -4 7 33 7 -4 59 7 31 7 -4 -4 7 33 11 -3 -3 11 34 12 -8 -1 15 38 18 14 21 39 7 63 51 54 0 32 14 5 11 27 -3 41 35 40 -4 24 15 6 17 36 10 57 53 63 22 53 34 28 41 66 29 16 15 20 
44 3 54 -4 24 20 44 20 24 -4 50 0 44 44 7 -6 10 44 41 -3 37 -19 14 9 28 9 19 -8 -17 16 -7 3 44 28 49 22 25 54 40 55 23 23 48 26 34 7 5 21 6 17 46 38 61 33 39 2 61 6 46 45 1 55 0 33 
20 13 50 13 24 31 24 13 50 7 20 20 17 -4 30 56 -1 -1 -20 13 -21 -5 -2 -4 -19 -53 -7 10 -48 27 18 0 35 0 6 6 57 26 59 1 6 1 46 16 36 50 54 45 23 62 17 27 27 18 68 27 50 60 58 36 16 45 -4 3 
44 -4 44 0 54 7 0 20 13 33 31 -4 54 20 17 48 44 5 1 24 18 -13 -19 -52 -45 -5 -59 -7 0 -6 17 9 37 28 60 50 3 60 14 4 29 22 42 36 0 61 21 20 55 56 23 29 3 7 46 54 25 35 10 23 0 13 -4 7 
54 20 20 50 39 0 54 3 50 59 31 33 3 2 22 18 38 14 17 -7 -11 -56 -60 -34 -36 -86 -20 -64 -73 -53 4 -42 13 26 3 6 33 25 47 31 37 15 23 58 57 21 9 31 20 41 21 36 16 20 58 56 20 16 35 21 39 20 31 7 
31 -4 3 54 17 17 -4 17 13 54 3 -4 24 39 22 56 -12 29 -23 -36 -3 -68 -87 -52 -45 -58 -94 -79 -89 -42 -27 -40 2 18 3 30 28 61 79 61 24 34 13 33 29 7 24 21 59 7 0 32 41 26 56 -3 41 -3 -3 33 59 50 20 31 
13 39 3 39 17 -4 50 33 31 33 39 54 3 20 49 13 46 11 -15 -42 2 -11 -24 -103 -104 -88 -54 -90 -49 -59 -3 -4 0 7 20 31 39 61 18 40 72 36 72 43 27 9 2 -3 0 13 20 44 3 31 0 39 20 3 -4 59 59 -4 3 20 
54 13 20 17 -4 24 39 39 20 59 13 17 3 39 0 6 -12 19 -27 -29 -50 -11 -64 -60 -72 -93 -54 -95 -81 -83 -22 -50 -24 -15 44 18 39 40 24 56 74 75 51 20 36 36 24 0 20 31 24 7 33 50 44 24 -4 17 17 3 39 -4 3 -4 
50 -4 50 17 31 24 3 24 31 17 44 59 50 20 33 29 9 17 15 -8 -62 -62 -85 -48 -115 -128 -73 -106 -92 -94 -33 -7 3 0 31 45 41 77 21 84 46 57 54 28 47 49 26 61 4 -4 31 54 50 24 61 -4 50 17 24 20 0 20 20 3 
44 20 -4 20 50 0 7 7 3 59 33 7 39 0 17 19 19 14 -9 21 -13 -63 -46 -42 -35 -46 -47 -58 -72 -92 -35 4 -27 6 22 32 26 15 61 36 58 79 18 23 16 3 50 22 59 20 41 55 -3 -3 57 35 18 55 18 33 54 -4 -4 54 
20 3 13 39 20 31 59 39 44 7 59 59 20 0 3 24 5 0 10 -22 -35 -21 -54 -64 -52 -81 -87 -64 -85 -84 -42 -57 -50 -13 43 46 3 49 52 73 41 40 44 15 72 16 49 31 50 18 11 23 57 45 62 24 12 24 54 36 45 14 -3 3 
20 39 59 7 20 44 0 20 44 0 20 54 13 39 3 31 -4 17 -20 7 -38 -12 -55 -12 -53 -18 -41 -73 -30 -38 -56 2 0 -7 -13 52 39 37 25 16 75 64 54 40 34 26 16 14 9 11 11 14 14 19 27 28 33 37 46 59 -2 9 21 31 
20 0 33 3 33 0 20 44 0 17 24 33 44 50 50 44 39 31 11 -14 31 0 -36 -2 -37 -11 -51 -24 -75 -45 -17 0 20 -24 -13 -5 0 2 67 55 44 30 6 50 22 57 21 45 11 35 61 13 31 41 54 55 62 62 54 41 31 19 0 45 
54 3 20 59 31 20 13 17 24 54 17 59 39 33 33 50 3 33 9 51 30 31 -37 -18 1 -21 -49 9 7 -45 -21 7 -11 -25 38 43 -9 19 45 22 1 65 61 68 17 39 7 54 39 40 49 73 31 69 43 32 27 35 43 70 30 8 57 51 
7 20 3 24 20 54 59 33 50 33 -4 -4 24 33 17 33 20 54 62 29 30 12 31 14 -19 -28 19 -37 9 -30 -33 0 10 -1 17 10 42 48 25 32 20 40 35 0 5 45 58 37 0 69 35 40 23 39 34 54 54 23 33 7 28 15 39 36 
3 3 20 -4 50 54 13 54 44 54 17 -4 59 3 33 20 20 33 10 63 6 19 58 46 55 8 -18 46 -18 9 -1 -12 3 -22 25 31 -7 33 28 42 5 48 43 61 22 0 3 23 58 41 50 76 46 38 48 67 45 36 45 70 42 38 50 15 
50 0 24 3 -4 0 17 50 20 17 21 39 7 54 44 50 3 34 19 18 26 50 19 69 67 64 18 48 21 14 12 38 2 -20 -27 -10 12 -8 -23 46 -5 19 -5 53 49 -3 22 0 58 61 10 39 17 75 79 24 49 20 74 75 19 39 18 1 
24 50 31 33 3 -4 18 60 -3 21 18 25 4 4 31 17 24 3 0 31 16 34 73 70 21 69 68 29 9 20 -13 -16 8 -5 2 -23 -24 5 -3 11 -18 -17 8 -8 3 38 34 63 40 49 16 81 32 79 84 41 25 36 73 70 21 71 7 37 
7 0 44 13 31 45 39 31 9 34 60 0 0 51 21 54 7 13 15 73 45 87 36 44 36 88 54 75 7 8 58 21 -15 9 8 3 -1 -27 10 37 -15 -15 43 18 -9 11 23 24 10 54 20 43 49 51 36 73 26 44 41 33 76 34 58 0 
39 39 7 13 50 54 26 35 13 20 -3 9 55 0 51 -3 45 4 62 18 84 41 37 61 59 88 79 36 19 37 30 50 38 3 1 -36 -31 4 11 -5 7 -15 2 52 0 46 -2 52 4 57 16 76 32 20 49 36 59 48 77 64 20 17 40 36 
39 59 39 54 26 31 0 0 27 23 46 31 52 27 40 13 21 62 63 32 31 60 52 73 57 63 112 108 57 45 60 36 -17 25 -29 12 20 -6 -4 28 28 -3 -15 10 -3 11 -3 4 51 54 18 18 46 36 66 43 53 24 35 64 59 22 10 28 
20 33 31 0 13 0 31 41 20 53 53 28 53 46 18 32 28 72 16 82 51 57 43 75 80 50 72 57 95 26 75 22 18 -4 16 11 -5 10 11 -12 7 6 44 -7 44 14 22 9 34 37 23 45 44 88 37 21 54 62 43 66 68 39 61 56 
59 -4 4 18 31 61 18 53 25 0 53 36 28 28 32 42 64 21 46 89 62 41 101 86 75 69 72 67 68 78 86 25 49 6 44 16 0 -5 -12 -9 -3 9 24 51 17 46 21 0 47 38 36 40 40 50 68 80 36 59 19 53 22 1 54 42 
7 33 54 54 35 4 24 28 18 57 14 20 14 56 18 28 31 21 56 84 94 88 58 91 99 86 53 72 73 59 22 39 40 31 9 38 -15 -7 40 11 36 49 36 15 40 56 50 29 71 23 21 84 49 71 80 57 29 52 49 37 8 28 34 27 
33 31 8 31 31 18 46 61 47 19 33 33 11 32 36 30 69 17 88 65 94 103 87 125 62 119 77 84 73 39 49 39 14 31 30 12 -14 6 0 43 3 7 -6 20 36 30 3 22 29 13 40 54 43 83 31 86 56 75 73 43 73 2 56 21 
50 4 13 18 18 5 56 28 -1 20 44 57 62 57 48 31 14 56 19 48 72 90 93 91 77 128 89 109 54 58 61 48 27 7 50 15 45 0 14 20 24 17 7 56 20 -5 21 36 55 62 64 55 35 78 48 69 89 23 22 13 61 32 10 34 
31 31 54 26 26 46 20 20 36 14 11 26 1 61 10 54 50 74 48 47 69 46 46 61 109 94 109 63 44 48 77 53 58 17 1 7 33 18 28 -4 50 -11 18 5 11 40 26 35 75 61 73 26 84 87 50 93 22 39 19 18 33 10 5 20 
24 3 45 20 0 41 20 6 53 33 20 1 57 37 28 20 13 11 81 76 80 78 81 76 78 75 75 72 67 66 62 58 61 58 -3 6 13 20 34 51 0 18 32 54 4 21 49 8 34 70 29 61 24 50 84 45 79 36 71 28 65 21 64 24 
17 50 13 34 -3 13 28 41 56 -2 1 1 -1 61 53 38 28 14 69 47 28 72 36 71 109 55 79 98 31 37 37 32 28 23 20 11 2 54 30 19 -5 32 6 40 4 31 63 20 39 64 76 18 30 34 32 34 21 82 61 44 20 64 29 0 
59 31 18 13 13 22 46 14 53 32 28 28 43 -2 25 0 50 45 52 66 24 59 31 87 77 73 89 32 54 18 62 39 34 43 61 18 54 31 19 20 21 40 0 33 17 8 7 16 33 61 29 73 64 62 65 87 29 64 36 19 20 16 26 45 
50 44 13 20 0 18 9 31 32 6 18 1 20 14 43 48 22 36 26 58 56 28 38 84 34 21 48 43 82 17 58 4 64 22 23 -3 9 61 18 13 45 50 21 39 24 54 54 26 30 11 33 18 56 65 28 45 23 40 33 0 5 49 63 39 
13 -4 59 7 39 26 26 51 23 13 20 47 20 14 23 57 33 31 52 22 7 14 36 78 67 72 26 66 50 62 14 59 54 0 28 14 18 31 4 61 -3 18 61 50 59 17 0 60 2 33 14 12 33 6 54 62 12 53 40 51 7 56 48 59 
39 54 13 54 33 33 50 9 51 32 32 52 11 52 36 37 57 18 64 51 57 6 36 14 78 8 26 52 25 14 17 28 -1 42 31 36 61 20 0 -3 0 20 54 31 25 31 51 21 2 -3 2 10 -10 39 31 45 0 29 17 16 33 -3 28 17 
44 17 13 31 17 20 54 50 0 46 52 14 1 18 61 61 20 6 18 59 60 17 0 13 48 37 63 36 38 7 -1 16 62 61 20 14 24 1 0 24 10 20 61 54 13 60 -3 24 14 33 10 16 -28 32 -21 21 27 -5 -25 -6 36 38 5 59 
20 31 31 20 0 31 54 -3 -3 51 21 56 10 18 14 1 36 1 18 22 18 3 37 5 16 20 13 63 28 53 0 1 61 36 5 25 36 37 25 1 32 56 -3 61 45 20 42 -11 -3 -16 30 1 20 -29 -27 -29 17 -2 21 -25 -19 44 21 3 
17 17 54 59 24 31 4 13 55 0 41 56 32 47 28 47 28 47 32 51 36 -3 53 10 1 22 22 51 46 10 10 36 42 10 10 48 53 26 28 6 14 56 0 45 61 34 47 16 31 13 27 10 -44 6 -38 -46 -11 -12 17 13 -18 -15 18 24 
17 31 17 20 0 3 39 34 0 61 18 0 18 -3 6 47 51 18 13 40 31 54 34 54 31 39 14 17 50 45 4 -3 14 -2 14 57 0 34 38 2 -1 20 14 26 13 18 -15 -13 13 10 -30 -38 -17 -39 -23 -39 -17 -38 -30 10 13 -13 -15 18 
39 -4 59 24 44 31 0 13 -3 21 27 10 28 28 6 20 18 51 -3 55 18 21 7 31 31 13 31 24 4 20 14 46 56 43 6 11 64 17 17 57 11 6 42 56 41 9 10 -15 10 3 -23 -2 -15 -50 -35 -42 1 18 10 -21 -3 -19 14 20 
7 3 3 13 20 33 60 20 50 20 -3 46 28 20 18 18 21 36 56 9 35 4 39 17 0 54 44 39 44 54 0 18 42 5 36 11 57 34 26 20 19 18 23 41 61 18 36 4 32 6 -18 -36 -53 -53 -50 -34 -18 8 -26 10 -13 34 18 13 
50 33 3 20 31 20 -3 20 25 20 0 27 41 36 20 56 4 10 61 26 54 60 50 20 50 59 54 31 -4 13 9 61 23 47 53 33 11 29 37 28 6 28 42 36 18 50 -14 -19 22 -11 3 6 -12 -46 -23 -6 -15 -36 -3 11 14 8 42 0 
31 31 13 33 39 24 -4 7 0 40 -3 -3 46 4 13 0 36 55 45 21 45 50 31 -4 3 -4 31 50 44 21 51 55 42 5 18 10 53 2 1 53 10 18 4 36 51 45 14 30 24 6 24 -44 17 -13 -2 0 -23 0 10 6 38 -8 52 24 
33 44 44 33 20 3 39 7 31 50 60 60 55 40 20 -3 21 50 4 13 18 13 0 44 20 54 13 31 44 50 45 31 18 61 24 56 10 19 24 20 14 -3 36 9 31 54 3 1 -6 -15 28 -1 -36 -1 10 -36 -25 -25 -27 30 12 -14 20 50 
44 7 59 -4 20 7 17 39 20 24 54 34 40 0 45 50 4 50 54 7 54 54 13 54 54 7 50 50 3 44 40 -3 31 26 52 20 18 32 4 0 18 55 45 -3 31 20 33 3 -14 -6 30 11 22 -8 -30 -8 22 11 24 -6 52 0 31 17 
39 59 7 20 44 0 20 39 0 20 45 7 31 -3 21 60 20 54 20 54 20 -4 31 3 44 20 -4 33 17 -4 39 20 4 51 31 20 4 61 45 36 22 18 9 0 -4 59 54 50 50 42 42 34 38 45 -27 -15 -6 0 14 21 39 54 0 17 
54 20 -4 24 59 20 44 0 17 24 39 50 54 59 60 54 44 31 20 3 50 24 3 39 7 33 0 20 44 0 17 24 34 40 45 45 41 36 26 18 0 45 21 0 33 7 39 3 24 50 -2 14 21 36 38 52 52 47 42 39 24 17 0 44 
3 20 50 20 0 59 54 -4 17 39 13 59 44 44 50 0 24 -4 39 24 20 31 44 3 39 17 3 0 3 20 39 7 54 34 31 34 50 9 34 13 0 60 -4 7 24 -4 31 17 13 13 20 44 7 50 18 20 20 31 54 17 54 33 20 20 
