7 -77 -76 68 -115 73 -22 63 109 -91 -78 -45 3 91 -6 -36 
-77 -30 -87 -57 35 110 -68 -100 -37 93 6 126 -55 118 -114 -76 
85 45 77 54 -99 -36 -72 114 1 -71 27 -25 128 -92 -77 89 
-62 58 5 68 103 -64 103 -11 118 121 48 -19 -9 -85 44 20 
-104 -13 -65 -17 -98 -35 -73 42 100 102 87 46 2 -27 -42 -23 
56 58 50 -34 12 -102 65 -22 76 82 -50 118 39 -73 -44 109 
-30 89 51 -37 -16 -16 120 29 101 -14 55 -22 90 93 96 -10 
85 16 -21 50 81 -110 39 -109 -20 -79 20 111 34 99 -100 -2 
-88 -56 108 -68 -81 48 -108 -81 -68 -85 -87 -85 -41 48 -45 -62 
-122 85 -70 76 18 -53 34 34 105 -27 87 -89 -120 -43 82 -18 
6 65 24 9 -88 -117 14 14 -16 66 -80 -66 -19 -45 9 21 
-111 48 65 20 -33 -18 -90 55 9 -122 -65 51 37 -16 -46 22 
-113 -40 3 46 77 -95 7 -79 -109 -68 76 92 -9 37 -7 -124 
31 -25 -13 31 60 31 -97 91 90 90 47 -82 -110 -80 -36 -21 
1 -25 -54 75 1 -113 60 -25 1 17 -70 -128 -23 -96 18 -11 
31 75 90 -99 46 -99 1 -40 90 -25 -54 60 -70 91 -69 -40 
