24 -110 112 6 37 -36 37 -5 98 113 8 54 -3 70 54 -65 -50 100 -95 100 -50 -65 70 100 24 84 39 -95 -95 39 84 24 100 70 -65 -50 100 -95 100 -50 -65 54 84 -3 54 24 114 114 8 39 -19 39 8 -109 -109 39 84 24 114 84 -33 -3 -95 -33 
-66 37 -53 -68 -22 80 21 5 67 -52 -96 -79 -3 -109 84 114 -33 114 100 -109 -3 -65 -79 -19 100 39 54 114 8 -33 -3 84 -3 -33 -3 100 24 8 70 -65 114 -109 -50 84 39 54 -95 39 8 39 -95 70 54 100 -33 -95 -95 -33 100 39 54 -95 39 8 
98 -112 -22 110 50 34 80 -69 67 5 6 38 -109 39 -19 -19 24 -109 24 -19 -19 24 -109 39 -3 -3 54 -79 70 24 39 84 -33 114 70 84 -95 24 -65 -95 -79 -3 100 24 -3 8 84 -33 -109 100 -109 -33 84 8 -3 8 84 -19 -95 -109 -79 8 -109 70 
-52 97 96 -38 -100 -39 95 79 -69 111 -98 38 24 100 24 39 -79 -109 -50 114 -109 -3 -50 -3 -95 -95 8 -49 -3 -109 114 -33 -109 -79 54 24 100 24 39 -79 114 -65 100 101 -33 -79 -33 114 114 -33 -95 -65 70 54 -109 70 100 -19 -50 8 -65 -50 54 24 
-97 -112 80 -24 78 -102 -85 -115 65 -37 50 112 113 83 24 -95 -3 39 39 -3 -79 39 114 -79 -94 101 25 -107 -32 -2 -18 -79 70 -65 -3 24 8 -65 84 -65 -2 9 -18 -93 40 -108 -64 -50 -79 84 -33 39 84 84 39 -33 70 -95 -65 -65 -109 39 -95 -33 
67 4 65 18 93 46 -117 92 -71 -85 2 -7 81 82 -51 -50 54 70 -50 -50 84 100 8 25 -62 -31 -105 -76 87 -106 72 115 54 114 70 -109 84 -79 -109 -32 -63 25 10 102 86 -48 -48 55 54 -65 -50 70 84 -19 -3 -95 -65 84 114 39 84 8 54 -3 
-21 -22 96 79 -56 -103 -27 -87 -26 -115 -85 66 67 -52 -81 23 -19 54 -3 39 -50 -19 116 118 -14 -29 59 14 75 13 58 -31 -2 114 114 -19 -33 39 -2 56 0 26 -62 -29 87 87 -47 -77 -2 -50 8 -65 -33 114 -109 8 -3 100 70 -95 84 -95 70 100 
98 81 -23 34 2 -117 -87 92 -41 -26 -86 -8 -7 -98 -36 -51 69 114 84 -50 -19 -77 12 29 -44 30 16 -87 -28 -58 75 103 56 -78 -65 114 -50 -32 116 -62 -76 58 103 75 -46 -15 -76 26 25 -49 39 24 -65 -3 -33 100 -95 100 -33 -19 -79 8 8 -65 
-81 -82 -68 -37 19 93 -56 47 -56 92 17 -39 -69 -83 -82 -51 -20 39 114 -19 85 -16 -105 75 31 -10 -10 -9 17 61 121 -45 57 -64 70 -19 -79 115 86 87 88 119 -75 1 75 -60 59 -30 -107 55 24 -3 -3 8 39 84 -79 8 114 -3 -95 70 8 -33 
-110 22 111 -112 96 18 108 -86 -103 62 -56 -9 4 -52 67 -97 -80 114 24 114 -94 117 28 -103 -56 -70 110 -8 49 47 -12 119 -47 -32 -65 84 -65 -32 -63 102 -29 13 14 -42 76 -103 -103 88 -16 56 84 54 -33 54 84 70 -3 100 -79 -79 100 -19 39 54 
24 -80 -5 -6 -83 2 18 -26 92 -102 -117 33 109 110 36 -98 -66 -110 24 70 56 -15 59 76 18 126 -66 128 20 94 76 1 88 102 39 -79 -32 -63 87 -76 -75 90 -57 -24 -71 47 107 90 0 74 72 8 114 -95 114 -3 54 54 -33 54 70 8 -109 -79 
-95 -19 23 53 52 36 -23 -100 34 -100 -10 49 79 80 51 6 -65 84 -50 39 102 -106 -89 -102 94 20 -82 37 126 -40 -11 1 -15 -63 114 24 -95 -2 56 102 118 120 77 18 -71 47 -87 -13 28 43 25 -2 -65 100 -19 84 -79 -33 -3 -3 -33 -95 70 -50 
-95 100 -95 8 -34 -6 111 51 79 -53 -100 -84 19 -37 -6 82 23 39 -95 70 85 -62 119 121 -26 -100 -84 -8 -85 -86 2 -90 -92 -18 -109 -109 -33 115 102 -62 89 76 -102 48 32 93 -10 -26 29 -76 -106 -48 85 54 101 -3 -33 8 -109 100 -95 24 -19 24 
54 84 114 -95 -65 -21 21 67 111 -68 -8 51 111 -52 21 98 -51 24 114 -33 71 -76 28 -103 16 123 4 124 17 -102 29 -75 73 -32 114 39 -50 115 25 -30 -105 76 15 -41 -101 93 48 3 -43 -75 -106 102 72 55 40 25 9 9 8 8 8 24 39 54 
24 24 24 -3 -33 -80 98 37 -36 111 4 -98 21 -112 -21 53 -109 -50 8 39 71 86 88 89 76 45 3 -42 -103 59 -29 118 -1 114 -3 84 -65 8 71 -107 -61 -28 -13 3 3 -10 -40 -72 105 43 -15 -105 41 -63 57 -63 40 -107 -32 39 100 -95 -65 -33 
54 70 114 -50 70 -33 -96 -111 -111 -66 5 -111 22 -35 -65 -65 -19 54 -79 54 -3 -49 -49 0 58 -75 59 -13 -45 -45 -15 40 -95 39 -33 -79 -95 -65 -3 102 -15 -90 105 92 122 -56 33 -87 76 29 14 29 75 -76 42 -30 -92 -106 -93 -49 39 -79 70 8 
-65 84 -95 100 -50 -50 84 113 38 113 82 -51 -51 99 -109 70 -79 -109 8 23 -51 -4 -51 39 25 -77 -46 118 -62 -92 -1 8 -95 -65 114 -50 -65 39 54 -33 10 -30 58 45 -74 -43 122 -59 -103 1 -13 119 -75 88 -75 -105 12 11 -76 -31 -94 -3 -19 100 
-19 114 84 114 -33 114 100 -109 -3 -65 -80 -19 100 39 54 -109 24 -19 7 82 -5 -21 5 113 36 23 85 -32 -94 -94 -33 100 54 84 -79 70 39 70 -65 100 85 -107 0 -60 -60 0 -103 89 105 -59 90 44 76 -60 90 75 119 -15 -76 -77 -18 100 54 54 
54 -50 -95 -109 -65 39 -65 -109 114 -65 24 -65 -109 -109 -65 39 -50 -96 -97 -36 67 -24 -70 -54 1 109 21 -6 8 70 -65 100 70 84 -95 24 -50 -79 -65 8 -108 56 42 57 -105 12 -45 -76 -45 28 -74 90 76 105 -43 75 13 0 41 116 9 -50 -50 -19 
70 -79 100 -109 8 -3 70 -3 8 -109 84 -95 70 70 -65 -108 -51 82 81 -67 108 -87 46 31 104 48 77 -39 -67 8 -79 -65 54 8 70 -19 -3 84 39 84 -19 -18 72 11 42 -62 -76 0 -75 -44 60 29 105 15 31 -102 105 -90 58 57 -93 101 -95 39 
-3 -50 84 -50 8 24 8 -50 84 -65 -19 -3 -32 -108 25 116 -79 -80 -111 33 -88 0 27 28 -16 -104 15 92 -114 112 54 -33 70 -109 -79 -95 84 -19 84 -109 -95 -109 55 -48 41 86 102 72 0 118 -46 0 0 -44 121 1 75 103 102 40 -49 70 -109 -79 
70 -109 70 -95 100 -65 -95 -19 -50 39 24 -108 102 -17 -31 87 85 -33 -36 93 103 0 9 -77 -48 102 -90 62 107 35 98 39 84 39 100 54 -109 84 -79 -109 -19 -50 39 25 -108 115 -1 -18 102 102 0 12 -90 -75 60 89 0 27 -62 -17 -94 -50 -109 -65 
100 -19 -19 84 54 -95 100 -79 84 114 25 40 -76 -76 11 -16 71 8 67 -10 13 -94 -81 38 22 -109 86 -75 -117 -69 98 -109 24 39 -95 -109 -19 -50 24 -33 8 -79 -50 84 84 -33 -64 24 -2 56 0 41 -46 -29 104 103 -29 -47 41 -17 55 -19 24 -65 
24 -109 -79 100 -33 -33 -109 -33 -50 101 -76 -106 11 58 12 119 -106 72 -81 -84 61 -107 -126 6 51 24 -107 -74 -116 -23 -5 -79 8 -3 -95 -33 -50 70 114 70 -65 -33 -95 -3 -3 -79 -3 -19 114 -64 -93 26 57 11 103 -106 57 -106 -107 39 114 84 -19 24 
-50 54 -79 54 -33 -109 84 40 25 40 58 103 -75 1 89 -28 103 9 -52 -102 103 86 82 -128 -84 -21 70 -76 46 -39 110 52 8 -19 -33 -19 8 54 -109 -19 84 -33 100 24 -33 -79 -95 -109 -95 -50 -2 72 -77 25 -92 56 -17 -77 -108 114 114 -109 -79 -19 
100 -50 -19 -33 -109 8 55 56 -1 117 -45 -28 -74 61 -88 -58 -90 57 -80 -53 -72 103 -33 24 22 -18 102 -59 -40 -83 68 -79 -50 -79 84 -65 -3 -19 -95 24 84 100 39 -65 8 24 -3 -95 -3 24 8 -64 39 85 72 9 -108 -32 -33 -79 54 -109 -79 -109 
84 -109 84 -33 24 9 -77 11 28 -28 77 121 92 -10 47 32 -43 43 71 5 -115 -73 -107 42 -124 -122 43 -88 -71 -113 22 70 54 -33 39 54 -3 100 -109 100 -19 39 39 -50 39 54 -3 114 -79 -109 24 100 84 8 115 -109 84 -33 8 -3 -95 -19 -19 -79 
70 -3 -109 -3 85 -93 -62 -62 -75 119 45 -58 62 -87 -25 4 15 0 -49 111 18 -102 -14 45 88 90 91 49 -9 -113 6 114 -65 -19 -3 -3 -50 -109 39 -65 24 100 -95 -65 -79 -109 70 -3 114 -19 54 100 -109 -109 100 39 -33 100 -33 39 100 -109 -109 100 
-19 -79 -50 54 -2 26 117 58 75 -59 122 122 -10 -86 -72 16 -59 -60 27 -50 -52 33 -57 -56 15 -56 -71 2 -69 -81 -3 -95 -109 -50 100 84 -95 39 24 84 -19 -33 8 -95 114 -65 70 24 84 -33 -65 -19 100 54 100 -19 -65 -19 84 39 70 -50 -109 -79 
-3 54 114 -65 -2 72 -92 -15 75 -88 6 108 -42 62 -73 30 -104 12 -106 11 -95 21 -84 66 -39 110 20 -69 82 8 -65 100 39 -33 -95 100 39 -3 -50 -95 100 70 39 8 -3 -33 -50 -50 -65 -65 -65 -65 -65 -50 -33 -19 8 24 54 100 -109 -65 -19 24 
-3 -95 39 -78 41 -92 1 75 -89 -26 17 47 79 92 91 77 59 27 -16 -77 101 22 -67 68 -37 82 -51 37 -109 -33 24 70 114 -95 -79 -79 -79 -95 114 70 24 -33 -109 39 -50 84 -33 70 -65 24 100 -79 -19 24 54 70 84 84 70 39 8 -33 -95 70 
100 -79 -3 114 25 -17 -47 -29 13 106 -26 121 61 44 43 89 -76 40 -63 115 84 100 -109 -33 68 -19 -95 114 114 -79 -19 84 -19 -79 114 114 -95 -19 70 -33 -109 100 84 114 -65 39 -79 84 39 39 54 114 -33 100 8 -33 -50 -19 24 114 -3 -79 100 84 
-65 -19 -79 8 -18 102 117 43 89 44 -103 -104 14 43 -29 42 -1 101 115 8 54 -19 70 39 -79 -79 85 -109 84 -79 -79 39 70 -3 54 8 114 114 8 39 -19 54 24 -109 -95 54 100 39 -109 114 -3 8 -65 -3 -50 39 39 -65 -33 -109 -33 -65 39 39 
-79 -79 -3 -109 85 102 -47 103 74 104 -28 -105 118 -76 42 -16 -18 39 -65 114 -95 -19 114 85 115 -18 -107 115 -78 40 -33 -33 24 -79 100 114 -50 84 54 84 -65 84 70 114 -19 -95 -95 -33 84 24 39 114 8 -33 -3 70 -3 -33 8 100 24 24 70 -50 
84 -95 8 -79 -109 -94 -31 87 0 -30 1 57 -62 103 72 85 -79 39 -33 -50 -33 39 -64 102 86 116 -47 72 10 -1 25 114 -3 -65 -79 -33 54 -50 -109 114 -79 8 -95 100 84 -109 -19 -109 84 84 -109 -19 -109 84 84 -95 -3 -95 100 114 -65 24 -50 -95 
8 84 24 39 -79 -109 -32 116 -107 -1 -30 10 -77 -77 25 -33 8 -79 -95 -3 -79 -32 86 73 -106 73 88 -30 -62 0 -93 -78 24 -19 24 -65 -65 24 -33 8 -95 -109 -33 -95 -65 54 24 100 24 39 -95 114 -65 84 84 -50 -95 -50 84 84 -65 114 -95 39 
-65 -95 70 -50 24 70 54 25 -64 40 116 -94 -94 85 -3 100 -65 -50 -65 114 9 116 -62 -47 -76 103 0 88 -105 -92 117 41 -78 8 39 39 8 -79 39 114 -79 -95 100 7 -109 -50 -19 -33 -95 54 -79 -19 -3 -19 -78 54 -95 -33 -33 -50 114 -3 84 -109 
54 54 -65 -50 84 100 8 39 -50 -19 -108 -65 100 -95 84 -109 70 -95 84 -79 115 -48 -76 0 -28 75 45 -90 -104 0 0 102 101 -19 -3 -109 -95 39 54 -33 -4 -96 -51 112 -80 83 -110 70 -109 70 -95 101 -64 -108 -32 -64 25 -2 100 70 -65 -65 39 39 
54 114 54 100 8 24 -95 -95 8 -3 70 24 84 8 54 -50 -33 100 84 -50 -78 -1 -47 12 -60 -27 121 120 0 0 87 56 -108 70 -109 54 84 -19 -19 99 82 -51 -97 -22 -81 -35 -111 -96 54 54 -78 -93 -1 -48 26 -32 10 -77 -49 70 70 -50 -79 8 
-19 39 24 -95 -50 -95 24 54 -19 84 84 8 84 70 -33 24 -3 114 -95 101 -31 -16 -91 0 1 -88 -25 -43 90 -104 103 -30 -1 -64 39 39 -33 39 38 -67 -6 -36 97 -99 81 -36 -22 -81 7 9 -77 0 -16 117 -76 -107 11 41 -17 85 100 24 100 100 
114 -109 -79 -33 24 114 -33 84 -3 -95 84 39 8 8 24 54 100 -65 8 114 9 -93 73 12 -28 -44 -43 -27 0 58 117 -31 85 -33 114 39 -19 -51 -67 -68 -52 -7 35 109 -23 80 -22 -112 53 9 -16 -31 -30 0 28 88 -61 26 -92 40 -49 -109 84 54 
-65 39 100 100 39 -79 -3 8 -33 100 -50 -19 -50 100 -33 8 -3 -65 39 100 101 56 -62 12 28 0 -103 -14 13 0 -92 10 55 54 -19 100 -79 -66 112 5 80 109 65 -25 65 109 80 5 112 -64 -76 103 -15 58 59 13 -90 0 11 -17 -108 -3 24 8 
39 24 -65 24 24 -33 70 114 70 -33 24 24 -65 24 39 -3 100 -95 114 24 85 86 11 102 -105 88 -28 12 0 -92 -16 -17 -78 24 54 8 -95 -34 -51 97 -53 -38 -101 1 49 18 -84 -23 -22 -95 -1 11 -29 90 -103 105 13 74 87 10 115 -109 100 -19 
84 -79 -50 -33 -33 -79 100 8 -109 -19 54 100 114 100 70 8 -79 54 -95 -19 24 55 41 11 -47 117 12 102 -47 0 25 25 -3 -65 100 -3 99 -67 -6 20 19 2 -56 106 0 -117 -40 19 66 69 54 11 -60 75 -42 45 105 -105 -91 -107 86 9 -79 39 
24 24 100 8 8 70 -19 -19 39 -50 -65 -3 -95 114 -65 84 54 114 8 -19 24 -79 -108 -63 72 41 87 -31 -77 -31 85 39 84 -33 -79 -50 54 7 37 -98 96 -114 -9 -72 -57 47 -10 2 109 52 70 -78 87 104 -43 120 -105 -30 -107 -93 -18 -95 -95 -19 
8 -79 70 -19 -95 54 -19 -79 84 24 -33 -95 100 39 8 -33 -79 -109 100 70 54 39 24 9 -2 -2 -1 9 9 25 39 54 84 100 -109 -65 -33 7 52 97 -83 -24 33 92 -87 -11 62 -102 -9 81 -65 25 -108 -17 89 -29 75 -46 73 -48 85 -33 114 8 
-33 84 -50 39 -109 -50 8 54 100 -109 -95 -95 -109 114 84 39 -19 -79 84 -3 -95 24 -95 8 114 -33 40 100 -95 -50 -19 -3 -3 -3 -19 -50 -79 99 37 -22 -112 35 -69 48 -86 16 106 -57 2 66 112 -96 -64 -63 -61 -61 -91 117 73 10 -64 100 8 -95 
114 24 -33 -50 -50 -3 70 -50 84 24 8 8 54 -109 -3 -109 70 39 39 70 -95 8 -95 84 39 39 84 -95 8 -95 70 24 24 54 114 -33 100 24 -20 -21 -6 51 -99 33 -39 -86 -102 -87 -26 65 -52 99 53 39 55 117 -47 73 -17 -64 -79 -79 -19 54 
84 70 -50 -19 -95 -33 -65 24 24 -79 -33 -95 -19 -50 54 70 -19 24 -33 54 39 -79 -50 100 -79 -109 -19 -19 114 -95 70 -95 114 -19 -3 -109 -65 114 -33 -51 68 81 -7 49 2 93 76 -26 2 -71 4 -38 67 82 -20 24 -33 39 9 -109 -95 54 114 54 
-50 -109 114 -65 54 8 8 84 -3 -50 -19 70 -19 -50 -3 100 24 8 70 -50 -109 -109 -33 100 54 84 -79 70 39 84 -65 100 84 -95 8 -50 -33 24 -79 114 -110 -34 112 80 110 -38 -115 109 -86 18 -39 -38 20 -82 98 113 -51 99 53 84 -65 100 70 114 
54 100 -50 100 39 39 84 -65 84 24 24 84 -65 84 39 39 100 -33 114 70 70 -109 -3 -95 114 -109 -50 54 -33 -65 -50 8 -109 54 24 39 114 -19 -95 -109 -95 -19 99 21 5 20 95 -8 -85 -100 -71 3 -100 79 66 97 -67 66 6 -4 39 -109 24 -33 
70 -33 -50 24 -33 -19 100 84 -95 70 84 -50 -95 -33 114 114 -19 -79 -33 100 100 -50 -109 -79 39 24 100 24 39 -79 -109 -50 114 114 -19 -50 -3 -95 -95 -3 -65 -19 113 98 -52 111 -99 35 4 78 3 18 -116 94 -86 65 79 -69 -113 -67 82 84 -65 114 
-19 24 24 -19 -95 24 100 -109 -109 84 -3 100 -65 -33 -50 -95 39 -95 -33 -3 -33 -95 39 -95 -50 -33 -65 114 8 84 -95 -95 114 39 -79 -3 39 39 -3 -95 24 100 -109 113 68 -22 81 -98 -69 -84 94 -10 93 -86 -72 -86 77 -25 65 -113 -112 99 24 -79 
-33 -33 100 114 8 24 -79 -50 100 -95 54 100 24 70 8 70 8 70 24 84 39 -109 84 -65 -95 -3 -19 84 70 -65 -65 39 54 -65 -65 70 84 -3 8 -79 -50 100 -95 70 113 37 98 22 80 36 95 49 -116 76 -73 -102 -11 -41 64 35 -99 -97 7 8 
-33 24 -33 -3 -95 -79 54 39 -95 114 -33 -95 -33 -109 -79 70 84 -33 -50 54 24 100 39 100 24 54 -50 -33 84 70 -79 -109 -50 -109 -50 100 -109 24 39 -95 -109 -19 -50 8 -50 -4 -96 -66 66 66 -69 -86 2 -43 14 -44 0 -89 -72 63 65 -68 -97 -4 
54 -109 114 8 70 24 -95 -50 -109 -3 8 -65 8 8 -79 -19 -33 84 -109 100 -33 -3 -65 24 24 -50 24 8 -79 -19 -50 70 100 54 -79 -65 114 -50 -50 100 -65 -79 54 100 54 -65 -33 -95 6 6 -67 19 3 -88 -29 -59 60 106 62 -71 -38 -112 -21 -4 
-65 -79 -79 -50 -19 39 114 -19 84 -19 -109 70 8 -19 -33 -33 -3 39 100 -65 39 -79 54 -33 -95 100 70 54 70 100 -95 -33 54 -79 39 -65 100 24 -3 -33 -33 -33 -3 54 114 -33 70 -33 99 22 -36 -69 -101 -102 -89 -43 0 75 -73 33 -69 81 6 -51 
84 39 -79 -3 24 -19 -109 -19 8 -19 -95 8 54 39 -19 100 -79 -65 114 8 100 114 84 -3 84 114 100 24 -109 -50 -65 114 -3 70 84 24 -65 8 39 8 -79 8 54 39 -33 84 -109 -109 69 -35 36 50 3 -102 -13 14 -14 -104 0 47 33 -23 81 -97 
24 24 -50 39 54 8 -109 -65 -95 54 -109 -109 70 -79 -50 -95 39 100 70 -3 70 84 24 -109 -79 -109 24 84 70 -3 84 100 54 -79 -33 -65 84 -95 -95 84 -65 -33 -79 39 84 70 -19 54 54 -4 98 -113 95 -25 32 16 -58 14 32 -9 96 -98 112 7 
39 70 70 39 -3 -79 54 -65 24 84 114 114 100 54 -19 -109 -3 84 -79 -50 -33 -50 -95 70 -19 100 -50 24 70 84 70 24 -33 114 -3 100 -65 -33 -3 -19 -50 -109 39 -65 24 100 -79 -65 -65 -95 83 -6 -113 -8 63 -116 -86 -87 -115 65 -7 -112 -5 83 
70 -65 114 -109 -3 -65 -33 54 -3 8 100 39 54 -95 70 84 -79 84 100 -65 100 100 -50 100 100 -65 84 84 -79 70 54 -109 24 8 84 -19 -33 24 -79 -95 -33 100 70 -109 24 -3 39 -79 -109 -65 70 22 67 -53 -100 -54 65 18 51 -68 111 -98 22 -34 
54 114 -65 -3 70 -95 -19 54 -95 -19 70 -65 24 -109 -3 114 -19 100 -19 100 -3 -109 24 -79 70 -19 -109 39 -33 -109 54 -19 -79 84 24 -19 -79 114 70 39 -3 -33 -65 -95 -109 114 100 84 84 84 84 84 99 112 -113 -98 -67 -53 -22 21 51 98 -96 -33 
100 -3 -109 8 114 -19 70 -95 -33 8 54 84 100 114 114 100 70 24 -19 -79 84 8 -79 54 -65 39 -95 -3 70 -95 -33 8 39 54 70 70 54 39 8 -33 -95 70 -3 -95 39 -65 54 -79 8 84 -79 -19 24 69 98 112 112 97 82 52 6 -34 -95 70 
-79 -19 84 -19 -95 114 100 -109 -33 54 -50 114 70 70 84 -95 8 -109 54 8 -3 24 70 -79 54 -33 -79 -95 -79 -19 54 -65 100 39 24 39 84 -65 39 -50 -95 114 -109 -65 8 -109 24 -33 -50 -50 -3 70 -65 84 7 -20 -4 22 99 -34 99 39 -3 -3 
