64 64

0000000000000000000000000000000000000000000000000000000000000000
0111110011111011111111011111111111111111011111111111111111111110
0001111101111100011111011110111100001110001111111111111111111100
0111101111011110111101110011111000100010111100011111000011110100
0001000111111111011110111110111100111111000001111101111111001100
0101110110001111110111000111100111000111100111011110000011101000
0110111111111111011111111100000011110111000111101110111100101100
0100100101101111001010000111111111111110101111111111111101111100
0000111111111001000101110000000110110001110011100110101011111100
0001011111011111011111111111111101111101111111011111111111111100
0111110111111111110111111111111011111111111100000000000000001110
0001000000111101010010101010000000001111111111111111111100000000
0001010101010000000111111111111111111111111111111111111111011110
0111111001111011011101111110000010010010001000001000001001110100
0100101011110101010111110111111110011110110111111111111111111100
0111110101011010111111110000111110111111110110001001111111100000
0111111111111111111101111111101111111111111111111111110111111100
0001111110111111110111111111011111111111101111111111101111111110
0111110001111011110111111011111011111111111101111111101111110110
0110111111011111101111111101111111111111000000000000000011111100
0111010110101101101011010111100000011111111111111111000011111100
0011110101010111111111011110000011111011111111110111111111000000
0111111100111110000111111111111110000000101011111111111010001100
0001011101111110111111111101111111011111111111011111111011111110
0111101111101111110111111101111111110111111111101000111111111110
0001111111011111111110111111111111011111111111110111111111111000
0111111101111111111011111111111011111111111011111111111111011100
0000000000000000000001111111100000111111110000111111111110000000
0000000111111111011111111111110111111100000001111111110111110000
0100011111010000000100000000100000001111111111111111111111110000
0100000000010000000011111111111111111000111111111111111011111110
0111011101111111011111111100000111111111110111111111100001111000
0001111111101111111101111111111110011111111111101111111101111110
0111111101111101111111110111111101111110111111111011111111101000
0111101110111111111110111111110111111111011111111110111111111110
0111111100001111111111101111111111101111111011111111110111111000
0000011111111110111110111111011111111011111111111111100011111100
0001111111111111011111110111111110111111111011111111111011111110
0111110111111111101111111101111111111011111111111011111111101110
0110101011111111111111111111101000000000111111101111000001110100
0001111111100011111111000011111111110000001000000000101111111100
0111100000001011111111111111101111111000001111111111100000000000
0101111111101111111111011111111111011111111111101111011111110000
0000111111001111110111111111111111011111111101111110111111000000
0100011000000000000111111111111101111101111111111111111011111100
0011111111111111111110111111111111110111111011111111101111111110
0011111111111111111000011111111111000111111000011111000011111110
0011111101111111111110111111111110000011111000111111100111111100
0011111111010110111111110101111111000111111011111101111111011110
0000111111101110110111111111011111110111111011101111011111011100
0111111100000011111011110111101111101111101111101111001111101110
0011111011101111101111011111011111111101111111101111111110111110
0111101011110111111111011111111110111111111111111111011110000110
0011111000000011000011111111111101111111111011111111111110111110
0111100000001111110111111111011111110111111110000011111100001110
0111110101111111011111111111011111100000011111111011111110111110
0111101111111011111110111111111111111111111111100000000011110100
0001101000000000111111110111111111110111111110101111111111110000
0001011000000000000001111111111011111111101111011111101111101110
0111000011111100000000001111101111101111111110110111111111110110
0111110111111110111111011111111110111111111110111111111101011110
0001111111110111111111011111111011111111111011111111011111111000
0111111111110111111111101111111111110111111111111111101111111110
0000000000000000000000000000000000000000000000000000000000000000

0000000000000000000000000000000000000000000000000000000000000000
0111110011111011111111011111111111111111011111111111111111111110
0001111101111100011111011110111100001110001111111111111111111100
0111101111011110111101110011111000100010111100011111000011110100
0001000111111111011110111110111100111111000001111101111111001100
0101110110001111110111000111100111000111100111011110000011101000
0110111111111111011111111100000011110111000111101110111100101100
0100100101101111001010000111111111111110101111111111111101111100
0000111111111001000101110000000110110001110011100110101011111100
0001011111011111011111111111111101111101111111011111111111111100
0111110111111111110111111111111011111111111100000000000000001110
0001000000111101010010101010000000001111111111111111111100000000
0001010101010000000111111111111111111111111111111111111111011110
0111111001111011011101111110000010010010001000001000001001110100
0100101011110101010111110111111110011110110111111111111111111100
0111110101011010111111110000111110111111110110001001111111100000
0111111111111111111101111111101111111111111111111111110111111100
0001111110111111110111111111011111111111101111111111101111111110
0111110001111011110111111011111011111111111101111111101111110110
0110111111011111101111111101111111111111000000000000000011111100
0111010110101101101011010111100000011111111111111111000011111100
0011110101010111111111011110000011111011111111110111111111000000
0111111100111110000111111111111110000000101011111111111010001100
0001011101111110111111111101111111011111111111011111111011111110
0111101111101111110111111101111111110111111111101000111111111110
0001111111011111111110111111111111011111111111110111111111111000
0111111101111111111011111111111011111111111011111111111111011100
0000000000000000000001111111100000111111110000111111111110000000
0000000111111111011111111111110111111100000001111111110111110000
0100011111010000000100000000100000001111111111111111111111110000
0100000000010000000011111111111111111000111111111111111011111110
0111011101111111011111111100000111111111110111111111100001111000
0001111111101111111101111111111110011111111111101111111101111110
0111111101111101111111110111111101111110111111111011111111101000
0111101110111111111110111111110111111111011111111110111111111110
0111111100001111111111101111111111101111111011111111110111111000
0000011111111110111110111111011111111011111111111111100011111100
0001111111111111011111110111111110111111111011111111111011111110
0111110111111111101111111101111111111011111111111011111111101110
0110101011111111111111111111101000000000111111101111000001110100
0001111111100011111111000011111111110000001000000000101111111100
0111100000001011111111111111101111111000001111111111100000000000
0101111111101111111111011111111111011111111111101111011111110000
0000111111001111110111111111111111011111111101111110111111000000
0100011000000000000111111111111101111101111111111111111011111100
0011111111111111111110111111111111110111111011111111101111111110
0011111111111111111000011111111111000111111000011111000011111110
0011111101111111111110111111111110000011111000111111100111111100
0011111111010110111111110101111111000111111011111101111111011110
0000111111101110110111111111011111110111111011101111011111011100
0111111100000011111011110111101111101111101111101111001111101110
0011111011101111101111011111011111111101111111101111111110111110
0111101011110111111111011111111110111111111111111111011110000110
0011111000000011000011111111111101111111111011111111111110111110
0111100000001111110111111111011111110111111110000011111100001110
0111110101111111011111111111011111100000011111111011111110111110
0111101111111011111110111111111111111111111111100000000011110100
0001101000000000111111110111111111110111111110101111111111110000
0001011000000000000001111111111011111111101111011111101111101110
0111000011111100000000001111101111101111111110110111111111110110
0111110111111110111111011111111110111111111110111111111101011110
0001111111110111111111011111111011111111111011111111011111111000
0111111111110111111111101111111111110111111111111111101111111110
0000000000000000000000000000000000000000000000000000000000000000