64 64
32 32
00000000000000000000000000000000
01111111111111111111111111111110
01111111111111111111111111111110
01111111000000000011111111111110
01110111011111111111111111111110
01110000011100011111111111111110
01111111111111011111111111111110
01110000000000011111111111111110
01111111111111111111111111111110
01111111111111111111111111111110
01111111111111111111111111111110
01111110000000000001111111111110
01111111111111111101111111111110
01111111111111111101111111111110
01111111111111111101111111111110
01111111111111111101111111111110
01111111111111111101111111111110
01111111111111111101111111111110
01111111111111111101111111111110
01111111111111111101111111111110
01111111111111111101111111111110
00000000000000111110000000000000
01111111111110111111111111111110
01111111111110111111111111111110
01111111111110111111111111111110
01111111111110111111111111111110
01111111111110111111111111111110
01111111111110111111111111111110
01111111111110111111111111111110
01111111111111111111111111111110
01111111111111111111111111111110
00000000000000000000000000000000

00000000000000000000000000000000
01111111111111111111111111111110
01111111111111111111111111111110
01111111000000000011111111111110
01110111011111111111111111111110
01110000011100011111111111111110
01111111111111011111111111111110
01110000000000011111111111111110
01111111111111111111111111111110
01111111111111111111111111111110
01111111111111111111111111111110
01111110000000000001111111111110
01111111111111111101111111111110
01111111111111111101111111111110
01111111111111111101111111111110
01111111111111111101111111111110
01111111111111111101111111111110
01111111111111111101111111111110
01111111111111111101111111111110
01111111111111111101111111111110
01111111111111111101111111111110
00000000000000111110000000000000
01111111111110111111111111111110
01111111111110111111111111111110
01111111111110111111111111111110
01111111111110111111111111111110
01111111111110111111111111111110
01111111111110111111111111111110
01111111111110111111111111111110
01111111111111111111111111111110
01111111111111111111111111111110
00000000000000000000000000000000

0 sprites/0.png
1 sprites/1.png