64 64
00000000000000000000000000000000
02011111111111111111111111111110
01110111111111111111111111111110
01110111000000000011111111111110
01110111011111111111111111111110
01110000011100011111111111111110
01111111111111011111131111111110
01110000000000011111111111111110
01111111111111111111111111111110
01111111111111111111111111111110
01111111111111111111111111111110
01111111111111111111111111111110
01111111111111111111111111111110
01111111111111111111111111111110
01111111111111111111211111111110
01113111111111111111111111111110
01111111111111111111111111111110
01111111111111111111111111111110
01111111111111111111111111111110
01111111111111111111111111111110
01111111111131111111111111111110
01111111111111111111111111111110
01111111111111111111111111111110
01111111111111111111111111111110
01111111111121111111111111111110
01111111111111111111111111111110
01111111111111111111111111111110
01111111111111111111311111111110
01111111111111111111111111111110
01112111111111111111111111111110
01111111111111111111111111111110
00000000000000000000000000000000

00000000000000000000000000000000
01011111111111111111111111111110
01110111111111111111111111111110
01110111000000000011111111111110
01110111011111111111111111111110
01110000011100011111111111111110
01111111111111011111111111111110
01110000000000011111111111111110
01111111111111111111111111111110
01111111111111111111111111111110
01111111111111111111111111111110
01111111111111111111111111111110
01111111111111111111111111111110
01111111111111111111111111111110
01111111111111111111111111111110
01111111111111111111111111111110
01111111111111111111111111111110
01111111111111111111111111111110
01111111111111111111111111111110
01111111111111111111111111111110
01111111111111111111111111111110
01111111111111111111111111111110
01111111111111111111111111111110
01111111111111111111111111111110
01111111111111111111111111111110
01111111111111111111111111111110
01111111111111111111111111111110
01111111111111111111111111111110
01111111111111111111111111111110
01111111111111111111111111111110
01111111111111111111111111111110
00000000000000000000000000000000