64 64

0000000000000000000000000000000000000000000000000000000000000000
0111111111111111111111111111111111111111111111111111111111111110
0111111111111111111000111000111111111111111111111111111111111110
0111111111111111111000110000111111111111111111111111111111111110
0111111111121111111011111110111111111111111101111111111111111110
0111111111111111111011111110111111111111110011111111111111111110
0111111111111111111111121111111111111011110011111111111111111110
0111121111111111111011111110111111111000000111111111111111111110
0111111111111111111011111110111111111000000111111111111111111110
0111111111111121111000010000111111111100000001111111111111111110
0111111111111111111000010000111111111100000000111111111111111110
0111111111111111111111111111111111111100000001111111111111111110
0111112111111111111111111111111111111110000111111111100001000010
0111111110011111111112111111111111111110111111111111101111110010
0111111110011110111111111111111111111111111111111111101111110010
0111111111001100111111111111111111111111111111111111111111111110
0111111111100000111111111111111111111111111111111111111111110010
0111111111111000011111111111111111111111111111111111101111110010
0111111111110000011111111111111111111111111111111111101111110010
0111111111100000011111111111111111111111111111111111100001000010
0111111111111111111111111111111111111111111111111111111111111110
0111111111111111111111111111110000111111111111111111111111111110
0111111111111111111111111111100110001111111111111111111111111110
0111111111111111111111111111001111111110011111111111111111111110
0111111111111111111111111111011111111111000011111111111111111110
0111111111111111111111111111111111111111111011111111111111111110
0111111111111111111111111111111111111111111011111111111111111110
0111000010000111111111111011111111111111111011111111001111111110
0111000010000111111111111011111111111111111011111110001111111110
0111011111100111111111110011111100011111111011111100001111111110
0111011111100111111111100111111100001111111111111000001111111110
0111111111111111111111101111111100001111111111110000000000000110
0111011111100111111111100111111100011111111111111000001111111110
0111011111100111111111110011111111111111111011111110001111111110
0111000010000111111111111011111111111111111011111111001111111110
0111000010000111111111111111111111111111111011111111111111111110
0111111111111111111111111111111111111111111011111111111111111110
0111111111111111111111111111011111111111111011111111111111111110
0111111111111111111111111111011111111111000011111111111111111110
0111111111111111111111111111001111111110011111111111111111111110
0111111111111111111111111111100110001111111111111111111111111110
0111111111111111111111111111110000111111111111111011111111111110
0111111111100001001111111111111111111111111111111111111111111110
0111111111110000001111111111111111111111111111111111100001000010
0111111111111000001111111111111111111111111111111111101111110010
0111111111111000001111111111111111111111111111111111101111110010
0111111111100010001111111111111111111111111111111111101111110010
0111111111001110011111111111111111111111111111111111101111110010
0111111110011111111111111111111111111100111111111111101111010010
0111111100111111111111111111111111111100001111111111101111110010
0111111111111111111111111111111111111100000011111111100001000010
0111111111111111111111111111111111111100000011111111111111111110
0111111111111111111000010000111111111100000111111111111111111110
0111111111111111111000010000111111111000001111111111111111111110
0111111111111111111011111110111111111001100111111111111111111110
0111111111111111111011111110111111111111100111111111111111111110
0111111111111111111111111111111111111111110011111111111111111110
0111111111111111111011111110111111111111111011111111111111111110
0111111111111111111011111110111111111111111011111111111111111110
0111111111111111111000010000111111111111111111111111111111111110
0111111111111111111000010000111111111111111111111111111111111110
0111111111111111111111111111111111111111111111111111111111111110
0111111111111111111111111111111111111111111111111111111111111110
0000000000000000000000000000000000000000000000000000000000000000

0000000000000000000000000000000000000000000000000000000000000000
0111111111111111111111111111111111111111111111111111111111111110
0111111111111111111000011000111111111111111111111111111111111110
0111111111111111111000010000111111111111111111111111111111111110
0111111111111111111011111110111111111111111101111111111111111110
0111111111111111111011111110111111111111110011111111111111111110
0111111111111111111111111111111111111011110011111111111111111110
0111111111111111111011111110111111111000000111111111111111111110
0111111111111111111011111110111111111000000111111111111111111110
0111111111111111111000010000111111111100000001111111111111111110
0111111111111111111000010000111111111100000000111111111111111110
0111111111111111111111111111111111111100000001111111111111111110
0111111111111111111111111111111111111110000111111111100001000010
0111111110011111111111111111111111111110111111111111101111110010
0111111110011110111111111111111111111111111111111111101111110010
0111111111001100111111111111111111111111111111111111111111111110
0111111111100000111111111111111111111111111111111111111111110010
0111111111111000011111111111111111111111111111111111101111110010
0111111111110000011111111111111111111111111111111111101111110010
0111111111100000011111111111111111111111111111111111100001000010
0111111111111111111111111111111111111111111111111111111111111110
0111111111111111111111111111110000111111111111111111111111111110
0111111111111111111111111111100110001111111111111111111111111110
0111111111111111111111111111001111111110011111111111111111111110
0111111111111111111111111111011111111111000011111111111111111110
0111111111111111111111111111111111111111111011111111111111111110
0111111111111111111111111111111111111111111011111111111111111110
0111000010000111111111111011111111111111111011111111001111111110
0111000010000111111111111011111111111111111011111110001111111110
0111011111100111111111110011111100011111111011111100001111111110
0111011111100111111111100111111100001111111111111000001111111110
0111111111111111111111101111111100001111111111110000000000000110
0111011111100111111111100111111100011111111111111000001111111110
0111011111100111111111110011111111111111111011111110001111111110
0111000010000111111111111011111111111111111011111111001111111110
0111000010000111111111111111111111111111111011111111111111111110
0111111111111111111111111111111111111111111011111111111111111110
0111111111111111111111111111011111111111111011111111111111111110
0111111111111111111111111111011111111111000011111111111111111110
0111111111111111111111111111001111111110011111111111111111111110
0111111111111111111111111111100110001111111111111111111111111110
0111111111111111111111111111110000111111111111111111111111111110
0111111111100001001111111111111111111111111111111111111111111110
0111111111110000001111111111111111111111111111111111100001000010
0111111111111000001111111111111111111111111111111111101111110010
0111111111111000001111111111111111111111111111111111101111110010
0111111111100010001111111111111111111111111111111111101111110010
0111111111001110011111111111111111111111111111111111101111110010
0111111110011111111111111111111111111100111111111111101111110010
0111111100111111111111111111111111111100001111111111101111110010
0111111111111111111111111111111111111100000011111111100001000010
0111111111111111111111111111111111111100000011111111111111111110
0111111111111111111000010000111111111100000111111111111111111110
0111111111111111111000010000111111111000001111111111111111111110
0111111111111111111011111110111111111001100111111111111111111110
0111111111111111111011111110111111111111100111111111111111111110
0111111111111111111111111111111111111111110011111111111111111110
0111111111111111111011111110111111111111111011111111111111111110
0111111111111111111011111110111111111111111011111111111111111110
0111111111111111111000010000111111111111111111111111111111111110
0111111111111111111000010000111111111111111111111111111111111110
0111111111111111111111111111111111111111111111111111111111111110
0111111111111111111111111111111111111111111111111111111111111110
0000000000000000000000000000000000000000000000000000000000000000

